category,name,mrp,discount_pct_raw,available_qty,discounted_price,weight_g,out_of_stock,qty,discount_amount,discount_pct,total_revenue_raw,price_per_gms,mrp_bucket,weight_kg,discounted_price_calc,total_revenue_calc
Fruits & Vegetables,Onion,2500,16,3,2100,1000,FALSE,1,400,0.6,1000,2.1,Medium,1,2100,2100
Fruits & Vegetables,Tomato Hybrid,4200,16,3,3500,1000,FALSE,1,700,0.8,1000,3.5,High,1,3500,3500
Fruits & Vegetables,Tender Coconut,5100,15,3,4300,58,FALSE,1,800,1,58,74.14,High,0.058,4300,4300
Fruits & Vegetables,Coriander Leaves,2000,15,3,1700,100,FALSE,100,300,1,10000,17,Medium,0.1,1700,170000
Fruits & Vegetables,Ladies Finger ,1400,14,3,1200,250,FALSE,250,200,0.8,62500,4.8,Low,0.25,1200,300000
Fruits & Vegetables,Potato,3500,17,3,2900,1000,FALSE,1,600,0.7,1000,2.9,Medium,1,2900,2900
Fruits & Vegetables,Lemon,7500,16,3,6300,200,FALSE,200,1200,1,40000,31.5,High,0.2,6300,1260000
Fruits & Vegetables,Watermelon ,5800,15,3,4900,58,FALSE,1,900,1,58,84.48,High,0.058,4900,4900
Fruits & Vegetables,Capsicum Green ,2300,17,3,1900,250,FALSE,250,400,0.9,62500,7.6,Medium,0.25,1900,475000
Fruits & Vegetables,Chilli Green ,1900,15,3,1600,100,FALSE,100,300,0.9,10000,16,Low,0.1,1600,160000
Fruits & Vegetables,Banana Robusta,2900,17,3,2400,348,FALSE,6,500,0.9,2088,6.9,Medium,0.348,2400,14400
Fruits & Vegetables,Garlic Indian ,1100,18,3,900,100,FALSE,100,200,0.9,10000,9,Low,0.1,900,90000
Fruits & Vegetables,Cauliflower,2600,15,3,2200,58,FALSE,1,400,1,58,37.93,Medium,0.058,2200,2200
Fruits & Vegetables,Ginger,1400,14,3,1200,200,FALSE,200,200,0.9,40000,6,Low,0.2,1200,240000
Fruits & Vegetables,Spinach,1900,15,3,1600,250,FALSE,250,300,0.9,62500,6.4,Low,0.25,1600,400000
Fruits & Vegetables,Muskmelon,4200,16,3,3500,58,FALSE,1,700,1,58,60.34,High,0.058,3500,3500
Fruits & Vegetables,Cabbage ,1500,13,3,1300,58,FALSE,1,200,1,58,22.41,Low,0.058,1300,1300
Fruits & Vegetables,Methi,3000,16,3,2500,250,FALSE,250,500,0.9,62500,10,Medium,0.25,2500,625000
Fruits & Vegetables,Broccoli,3600,16,3,3000,500,FALSE,500,600,0.9,250000,6,Medium,0.5,3000,1500000
Fruits & Vegetables,Sapota,3000,16,3,2500,348,FALSE,6,500,0.9,2088,7.18,Medium,0.348,2500,15000
Fruits & Vegetables,Onion,6800,16,3,5700,3000,FALSE,3,1100,0.6,9000,1.9,High,3,5700,17100
Fruits & Vegetables,Potato,10000,16,3,8400,3000,FALSE,3,1600,0.7,9000,2.8,High,3,8400,25200
Fruits & Vegetables,Orange Nagpur,8200,15,3,6900,232,FALSE,4,1300,1,928,29.74,High,0.232,6900,27600
Fruits & Vegetables,Mint Leaves ,1100,18,3,900,100,FALSE,100,200,0.9,10000,9,Low,0.1,900,90000
Fruits & Vegetables,Beans French,3300,15,3,2800,250,FALSE,250,500,0.9,62500,11.2,Medium,0.25,2800,700000
Fruits & Vegetables,Bottle Gourd ,2600,15,3,2200,58,FALSE,1,400,1,58,37.93,Medium,0.058,2200,2200
Fruits & Vegetables,Banana Elaichi ,5800,15,3,4900,348,FALSE,6,900,0.9,2088,14.08,High,0.348,4900,29400
Fruits & Vegetables,Coconut Big,3600,16,3,3000,58,FALSE,1,600,1,58,51.72,Medium,0.058,3000,3000
Fruits & Vegetables,Curry Leaves,1300,15,3,1100,50,FALSE,50,200,1,2500,22,Low,0.05,1100,55000
Fruits & Vegetables,Brinjal Bharta,1900,15,3,1600,58,FALSE,1,300,1,58,27.59,Low,0.058,1600,1600
Fruits & Vegetables,Lettuce Iceberg,2500,16,3,2100,250,FALSE,250,400,0.9,62500,8.4,Medium,0.25,2100,525000
Fruits & Vegetables,Papaya,5400,16,3,4500,58,FALSE,1,900,1,58,77.59,High,0.058,4500,4500
Fruits & Vegetables,Apple Shimla,14200,16,3,11900,232,FALSE,4,2300,1,928,51.29,High,0.232,11900,47600
Fruits & Vegetables,Bitter Gourd,1800,16,3,1500,250,FALSE,250,300,0.9,62500,6,Low,0.25,1500,375000
Fruits & Vegetables,Brinjal Small,1800,16,3,1500,250,FALSE,250,300,0.9,62500,6,Low,0.25,1500,375000
Fruits & Vegetables,Sweet Corn,3600,16,3,3000,116,FALSE,2,600,1,232,25.86,Medium,0.116,3000,6000
Fruits & Vegetables,Spring Onion ,1800,16,3,1500,250,FALSE,250,300,0.9,62500,6,Low,0.25,1500,375000
Fruits & Vegetables,Bell Peppers Red & Yellow ,11800,16,3,9900,116,FALSE,2,1900,1,232,85.34,High,0.116,9900,19800
Fruits & Vegetables,Pomegranate ,10600,16,3,8900,116,FALSE,2,1700,1,232,76.72,High,0.116,8900,17800
Fruits & Vegetables,Sweet Lime,3000,16,3,2500,116,FALSE,2,500,1,232,21.55,Medium,0.116,2500,5000
Fruits & Vegetables,Baby Potato,1900,15,3,1600,500,FALSE,500,300,0.7,250000,3.2,Low,0.5,1600,800000
Fruits & Vegetables,Coccinia,3200,15,3,2700,250,FALSE,250,500,0.9,62500,10.8,Medium,0.25,2700,675000
Fruits & Vegetables,Guava,5400,16,3,4500,232,FALSE,4,900,1,928,19.4,High,0.232,4500,18000
Fruits & Vegetables,Apple Washington,17700,15,3,14900,232,FALSE,4,2800,1,928,64.22,High,0.232,14900,59600
Fruits & Vegetables,Amla,3200,15,3,2700,250,FALSE,250,500,0.9,62500,10.8,Medium,0.25,2700,675000
Fruits & Vegetables,Beans Cluster,3000,16,3,2500,250,FALSE,250,500,0.9,62500,10,Medium,0.25,2500,625000
Fruits & Vegetables,Apple Royal Gala,18900,15,3,15900,232,FALSE,4,3000,1,928,68.53,High,0.232,15900,63600
Fruits & Vegetables,Chilli Bhaji,3000,16,3,2500,250,FALSE,250,500,0.9,62500,10,Medium,0.25,2500,625000
Fruits & Vegetables,Lettuce Green,2300,17,3,1900,100,FALSE,100,400,1,10000,19,Medium,0.1,1900,190000
Fruits & Vegetables,Baby Corn Peeled,3500,17,3,2900,250,FALSE,250,600,0.9,62500,11.6,Medium,0.25,2900,725000
Fruits & Vegetables,Mixed Sprouts,3500,17,3,2900,200,FALSE,200,600,0.9,40000,14.5,Medium,0.2,2900,580000
Fruits & Vegetables,Zucchini Green,3500,17,3,2900,250,FALSE,250,600,0.9,62500,11.6,Medium,0.25,2900,725000
Fruits & Vegetables,Beans Broad,4200,16,3,3500,250,FALSE,250,700,0.9,62500,14,High,0.25,3500,875000
Fruits & Vegetables,Raw Banana,2000,15,6,1700,500,FALSE,500,300,0.8,250000,3.4,Medium,0.5,1700,850000
Fruits & Vegetables,Colocasia ,2900,17,6,2400,500,FALSE,500,500,0.8,250000,4.8,Medium,0.5,2400,1200000
Fruits & Vegetables,Tomato Cherry ,3500,17,3,2900,200,FALSE,200,600,0.9,40000,14.5,Medium,0.2,2900,580000
Fruits & Vegetables,Sweet Potato ,3800,15,3,3200,500,FALSE,500,600,0.9,250000,6.4,Medium,0.5,3200,1600000
Fruits & Vegetables,Pineapple Slice,8900,15,3,7500,200,FALSE,200,1400,1,40000,37.5,High,0.2,7500,1500000
Fruits & Vegetables,Orange,5400,16,3,4500,116,FALSE,2,900,1,232,38.79,High,0.116,4500,9000
Fruits & Vegetables,Dragon Fruit Imported,7000,15,3,5900,58,FALSE,1,1100,1,58,101.72,High,0.058,5900,5900
Fruits & Vegetables,Zucchini Yellow,4200,16,3,3500,250,FALSE,500,700,0.9,125000,14,High,0.25,3500,1750000
Fruits & Vegetables,Apple Kinnaur,14200,16,6,11900,232,FALSE,4,2300,1,928,51.29,High,0.232,11900,47600
Fruits & Vegetables,Pineapple,9400,15,3,7900,58,FALSE,1,1500,1,58,136.21,High,0.058,7900,7900
Fruits & Vegetables,Basil,2000,15,3,1700,100,FALSE,100,300,1,10000,17,Medium,0.1,1700,170000
Fruits & Vegetables,Parsley,1700,17,3,1400,100,FALSE,100,300,0.9,10000,14,Low,0.1,1400,140000
Fruits & Vegetables,Ridge Gourd,3000,16,3,2500,500,FALSE,500,500,0.8,250000,5,Medium,0.5,2500,1250000
Fruits & Vegetables,Papaya Cut,4600,15,3,3900,200,FALSE,200,700,1,40000,19.5,High,0.2,3900,780000
Fruits & Vegetables,Pomegranate Peeled,5800,15,2,4900,100,FALSE,100,900,1,10000,49,High,0.1,4900,490000
Fruits & Vegetables,Pear Green Imported,8200,15,3,6900,116,FALSE,2,1300,1,232,59.48,High,0.116,6900,13800
Fruits & Vegetables,Guava Thai,7000,15,3,5900,116,FALSE,2,1100,1,232,50.86,High,0.116,5900,11800
Fruits & Vegetables,Lettuce Red,2000,15,3,1700,100,FALSE,100,300,1,10000,17,Medium,0.1,1700,170000
Fruits & Vegetables,Mango Raw,6000,16,3,5000,500,FALSE,500,1000,0.9,250000,10,High,0.5,5000,2500000
Fruits & Vegetables,Biryani /Pulav Mix,5800,15,3,4900,250,FALSE,250,900,1,62500,19.6,High,0.25,4900,1225000
Fruits & Vegetables,Banana Nendran,5400,16,6,4500,500,FALSE,500,900,0.9,250000,9,High,0.5,4500,2250000
Fruits & Vegetables,Pumpkin Cut,3000,16,3,2500,200,FALSE,200,500,0.9,40000,12.5,Medium,0.2,2500,500000
Fruits & Vegetables,Banana Red,5400,16,6,4500,500,FALSE,500,900,0.9,250000,9,High,0.5,4500,2250000
Fruits & Vegetables,Radish White,2300,17,6,1900,500,FALSE,500,400,0.8,250000,3.8,Medium,0.5,1900,950000
Fruits & Vegetables,Avocado Indian Premium,17700,15,3,14900,58,FALSE,1,2800,1,58,256.9,High,0.058,14900,14900
Fruits & Vegetables,Banana Leaf,1200,16,2,1000,58,FALSE,1,200,1,58,17.24,Low,0.058,1000,1000
Fruits & Vegetables,Sponge Gourd,2500,16,2,2100,300,FALSE,300,400,0.9,90000,7,Medium,0.3,2100,630000
Fruits & Vegetables,Zama Organics Carrot,2000,15,3,1700,250,FALSE,250,300,0.9,62500,6.8,Medium,0.25,1700,425000
Fruits & Vegetables,Safal Frozen - Mixed Vegetables,11000,4,2,10500,1000,FALSE,1,500,0.9,1000,10.5,High,1,10500,10500
Fruits & Vegetables,Zama Organics Sweet Potato,3700,16,3,3100,250,FALSE,250,600,0.9,62500,12.4,Medium,0.25,3100,775000
Fruits & Vegetables,Beetroot,1600,18,3,1300,500,FALSE,500,300,0.7,250000,2.6,Low,0.5,1300,650000
Fruits & Vegetables,Capsicum,2600,19,3,2100,500,FALSE,500,500,0.8,250000,4.2,Medium,0.5,2100,1050000
Fruits & Vegetables,Carrot,1900,21,3,1500,500,FALSE,500,400,0.7,250000,3,Low,0.5,1500,750000
Fruits & Vegetables,Garlic,1700,23,3,1300,200,FALSE,200,400,0.9,40000,6.5,Low,0.2,1300,260000
Fruits & Vegetables,Carrot,1300,15,0,1100,250,TRUE,200,200,0.8,50000,4.4,Low,0.25,1100,220000
Fruits & Vegetables,Beetroot,1100,18,0,900,250,TRUE,250,200,0.8,62500,3.6,Low,0.25,900,225000
Fruits & Vegetables,Moong Sprouts,3500,17,0,2900,200,TRUE,200,600,0.9,40000,14.5,Medium,0.2,2900,580000
Fruits & Vegetables,Safal Frozen Mixed Vegetables,6000,5,0,5700,500,TRUE,500,300,0.9,250000,11.4,High,0.5,5700,2850000
Fruits & Vegetables,Safal Frozen Corn,4100,4,0,3900,200,TRUE,200,200,1,40000,19.5,High,0.2,3900,780000
Fruits & Vegetables,Safal Frozen - Sweet Corn,16000,5,0,15200,1000,TRUE,1,800,0.9,1000,15.2,High,1,15200,15200
Cooking Essentials,Maggi 2 Minute Masala Noodles,1200,0,6,1200,70,FALSE,70,0,0.9,4900,17.14,Low,0.07,1200,84000
Cooking Essentials,iD Idli & Dosa Batter ,8000,15,6,6800,1000,FALSE,1,1200,0.9,1000,6.8,High,1,6800,6800
Cooking Essentials,Tata Salt,2400,0,6,2400,1000,FALSE,1,0,0.6,1000,2.4,Medium,1,2400,2400
Cooking Essentials,Arden Eggs White,9700,0,4,9700,696,FALSE,12,0,0.9,8352,13.94,High,0.696,9700,116400
Cooking Essentials,Arden Eggs White,6500,15,4,5500,348,FALSE,6,1000,0.9,2088,15.8,High,0.348,5500,33000
Cooking Essentials,Fortune Sunlite Refined Sunflower (Pouch),23000,4,6,21900,1000,FALSE,1,1100,1,1000,21.9,High,1,21900,21900
Cooking Essentials,Aashirvaad Superior MP Atta,25000,2,6,24500,5000,FALSE,5,500,0.8,25000,4.9,High,5,24500,122500
Cooking Essentials,Amul Pure Ghee (Pouch),25500,2,6,24900,500,FALSE,500,600,1,250000,49.8,High,0.5,24900,12450000
Cooking Essentials,Arden Eggs Brown,8500,7,4,7900,348,FALSE,6,600,1,2088,22.7,High,0.348,7900,47400
Cooking Essentials,Tata Salt Lite,4000,10,6,3600,1000,FALSE,1,400,0.8,1000,3.6,High,1,3600,3600
Cooking Essentials,Saffola Gold Oil (Pouch),21500,0,6,21500,1000,FALSE,1,0,1,1000,21.5,High,1,21500,21500
Cooking Essentials,Fortune Sunlite Refined Sunflower (Jar),92500,0,6,92500,5000,FALSE,5,0,0.9,25000,18.5,High,5,92500,462500
Cooking Essentials,Fortune Rice Bran (Pouch),22500,11,6,19900,1000,FALSE,1,2600,1,1000,19.9,High,1,19900,19900
Cooking Essentials,Saffola Active Oil,21000,0,6,21000,1000,FALSE,1,0,1,1000,21,High,1,21000,21000
Cooking Essentials,Amul Pure Ghee (Pouch),50500,1,2,49900,1000,FALSE,1,600,1,1000,49.9,High,1,49900,49900
Cooking Essentials,Aashirvaad Atta,46000,13,6,39900,10000,FALSE,10,6100,0.8,100000,3.99,High,10,39900,399000
Cooking Essentials,Popular Essentials Toor Dal (Un-Polished),16000,6,4,14900,1000,FALSE,1,1100,0.9,1000,14.9,High,1,14900,14900
Cooking Essentials,Amul Ghee (Tin),52000,2,6,50900,1000,FALSE,1,1100,1,1000,50.9,High,1,50900,50900
Cooking Essentials,Amul Fresh Cream,19700,3,3,19100,1000,FALSE,1,600,0.9,1000,19.1,High,1,19100,19100
Cooking Essentials,Popular Essentials Pure Jaggery,5000,2,6,4900,450,FALSE,450,100,0.9,202500,10.89,High,0.45,4900,2205000
Cooking Essentials,Aashirvaad Multigrain Atta,6400,3,2,6200,1000,FALSE,1,200,0.8,1000,6.2,High,1,6200,6200
Cooking Essentials,Fortune Soyabean Oil,100500,0,6,99900,5000,FALSE,5,600,1,25000,19.98,High,5,99900,499500
Cooking Essentials,Popular Essentials Sunflower Seeds,2500,0,6,2500,50,FALSE,50,0,1,2500,50,Medium,0.05,2500,125000
Cooking Essentials,Tata Sampann kabuli chana,18500,1,4,18300,1000,FALSE,500,200,0.9,500000,18.3,High,1,18300,9150000
Cooking Essentials,Dhara Groundnut Oil (Pouch),23000,11,6,20300,1000,FALSE,1,2700,1,1000,20.3,High,1,20300,20300
Cooking Essentials,Dhara Health Refined Sun Flower Oil Jar,120000,18,6,98400,5000,FALSE,5,21600,1,25000,19.68,High,5,98400,492000
Cooking Essentials,24 Mantra Organic Jaggery Powder,8000,15,6,6800,500,FALSE,500,1200,0.9,250000,13.6,High,0.5,6800,3400000
Cooking Essentials,Tata Sampann High Protien Kabuli Chana,9400,0,1,9400,500,FALSE,500,0,0.9,250000,18.8,High,0.5,9400,4700000
Cooking Essentials,Dhara Kachi Ghani Mustard Oil Jar,125000,8,6,114300,5000,FALSE,5,10700,1,25000,22.86,High,5,114300,571500
Cooking Essentials,D'lecta Dairy Cream,5400,5,6,5100,200,FALSE,200,300,1,40000,25.5,High,0.2,5100,1020000
Cooking Essentials,Ching's Secret Instant Hot Garlic Noodles,1500,0,3,1500,60,FALSE,60,0,1,3600,25,Low,0.06,1500,90000
Cooking Essentials,Dabur Ginger Garlic Paste,2500,8,3,2300,100,FALSE,100,200,1,10000,23,Medium,0.1,2300,230000
Cooking Essentials,Ching's Secret Instant Schezwan Noodles,1500,0,6,1500,60,FALSE,60,0,1,3600,25,Low,0.06,1500,90000
Cooking Essentials,Gowardhan Ghee/Tuppa Jar,31500,1,6,30900,500,FALSE,500,600,1,250000,61.8,High,0.5,30900,15450000
Cooking Essentials,Tata Sampann Unpolished Moong Dal ,9200,4,4,8800,500,FALSE,500,400,0.9,250000,17.6,High,0.5,8800,4400000
Cooking Essentials,Aashirvaad Select Atta,6400,0,6,6400,1000,FALSE,1,0,0.8,1000,6.4,High,1,6400,6400
Cooking Essentials,Popular Essentials Misri Dana (Diamond Sugar) ,1500,0,4,1500,100,FALSE,100,0,0.9,10000,15,Low,0.1,1500,150000
Cooking Essentials,Gowardhan Ghee Jar,59800,3,6,57900,1000,FALSE,1,1900,1,1000,57.9,High,1,57900,57900
Cooking Essentials,Top Ramen  Noodles Curry Veg Pouch,2000,0,1,2000,70,FALSE,70,0,1,4900,28.57,Medium,0.07,2000,140000
Cooking Essentials,Popular Essentials Refined Sugar,6000,0,6,6000,1000,FALSE,1,0,0.8,1000,6,High,1,6000,6000
Cooking Essentials,Fortune Kachi Ghani Mustard Oil Bottle,21600,7,6,19900,1000,FALSE,1,1700,1,1000,19.9,High,1,19900,19900
Cooking Essentials,Saffola Veggie Twist Masala Oats,1500,0,6,1500,38,FALSE,38,0,1,1444,39.47,Low,0.038,1500,57000
Cooking Essentials,Satyam Puffed Rice Kurmura (R),2300,0,6,2300,200,FALSE,200,0,0.9,40000,11.5,Medium,0.2,2300,460000
Cooking Essentials,Quaker Oats,7900,0,2,7900,400,FALSE,400,0,0.9,160000,19.75,High,0.4,7900,3160000
Cooking Essentials,Aashirvaad Select Sharbati Atta,31500,10,6,28300,5000,FALSE,5,3200,0.8,25000,5.66,High,5,28300,141500
Cooking Essentials,Popular Essentials Refined Sugar,29500,10,6,26500,5000,FALSE,5,3000,0.8,25000,5.3,High,5,26500,132500
Cooking Essentials,Gowardhan Cow Ghee Pouch,57900,10,6,52100,1000,FALSE,1,5800,1,1000,52.1,High,1,52100,52100
Cooking Essentials,Dhara Nourish Refined Sunflower Oil Pouch,21000,5,6,19900,1000,FALSE,1,1100,1,1000,19.9,High,1,19900,19900
Cooking Essentials,Parachute Oil ,4000,7,3,3700,100,FALSE,100,300,1,10000,37,High,0.1,3700,370000
Cooking Essentials,Popular Essentials Plain Puffed Rice (Murmura/Muri),1800,0,6,1800,100,FALSE,100,0,0.9,10000,18,Low,0.1,1800,180000
Cooking Essentials,Amul Mithai Mate Condensed Sweetened Milk,5600,3,4,5400,200,FALSE,200,200,1,40000,27,High,0.2,5400,1080000
Cooking Essentials,Saffola Gold (Jar),124000,0,6,124000,5000,FALSE,5,0,1,25000,24.8,High,5,124000,620000
Cooking Essentials,McCain New Mini Samosa with Cheese Pizza Style Filling,12000,1,3,11800,240,FALSE,240,200,1,57600,49.17,High,0.24,11800,2832000
Cooking Essentials,Fortune Rice Bran Health Oil (Jar),105000,1,6,103900,5000,FALSE,5,1100,1,25000,20.78,High,5,103900,519500
Cooking Essentials,Arden Desi Eggs,11000,13,4,9500,348,FALSE,6,1500,1,2088,27.3,High,0.348,9500,57000
Cooking Essentials,Fortune Rozana Basmati Rice,58500,21,6,46200,5000,FALSE,5,12300,0.9,25000,9.24,High,5,46200,231000
Cooking Essentials,Fortune Biriyani Special Basmati Rice,17500,0,5,17500,1000,FALSE,1,0,0.9,1000,17.5,High,1,17500,17500
Cooking Essentials,Everest Garam Masala,7800,7,5,7200,100,FALSE,100,600,1,10000,72,High,0.1,7200,720000
Cooking Essentials,Popular Essentials Pumpkin Seeds,9000,16,6,7500,100,FALSE,100,1500,1,10000,75,High,0.1,7500,750000
Cooking Essentials,Fortune Soya Health Refined Soybean Oil,21000,1,2,20600,1000,FALSE,1,400,1,1000,20.6,High,1,20600,20600
Cooking Essentials,Gowardhan Pure Ghee Pouch,29500,4,6,28100,500,FALSE,500,1400,1,250000,56.2,High,0.5,28100,14050000
Cooking Essentials,Popular Essentials Jeera/Cumin Seeds,4000,5,3,3800,100,FALSE,100,200,1,10000,38,High,0.1,3800,380000
Cooking Essentials,Weikfield Baking Soda,3000,3,6,2900,100,FALSE,100,100,1,10000,29,Medium,0.1,2900,290000
Cooking Essentials,Everest Pav Bhaji Masala,3700,10,4,3300,50,FALSE,50,400,1,2500,66,Medium,0.05,3300,165000
Cooking Essentials,Tata Sampann Unpolished Chana Dal,9500,6,2,8900,1000,FALSE,500,600,0.9,500000,8.9,High,1,8900,4450000
Cooking Essentials,Amul Mithai Mate EOE Tin,11200,2,6,10900,400,FALSE,400,300,1,160000,27.25,High,0.4,10900,4360000
Cooking Essentials,Pillsbury Chakki Fresh Atta,45000,16,6,37500,10000,FALSE,10,7500,0.8,100000,3.75,High,10,37500,375000
Cooking Essentials,Everest Chicken Masala,3900,2,1,3800,50,FALSE,50,100,1,2500,76,Medium,0.05,3800,190000
Cooking Essentials,Dhara Life Refined Ricebran Oil (Pouch),20500,7,6,19000,1000,FALSE,1,1500,1,1000,19,High,1,19000,19000
Cooking Essentials,Borges Extra Virgin Olive Oil,40000,25,1,29900,250,FALSE,250,10100,1,62500,119.6,High,0.25,29900,7475000
Cooking Essentials,Everest Shahi Biryani Masala,7000,14,6,6000,50,FALSE,50,1000,1,2500,120,High,0.05,6000,300000
Cooking Essentials,Popular Essentials Californian Almond,35000,28,6,25100,250,FALSE,250,9900,1,62500,100.4,High,0.25,25100,6275000
Cooking Essentials,Popular Essentials Ajwain Whole,2500,0,4,2500,50,FALSE,50,0,1,2500,50,Medium,0.05,2500,125000
Cooking Essentials,Everest Tikhalal Chilli Powder,23500,9,6,21200,500,FALSE,500,2300,1,250000,42.4,High,0.5,21200,10600000
Cooking Essentials,Popular Essentials Kabuli Chana Regular,8500,9,6,7700,500,FALSE,500,800,0.9,250000,15.4,High,0.5,7700,3850000
Cooking Essentials,Pillsbury Chakki Fresh Atta,5200,0,4,5200,1000,FALSE,1,0,0.8,1000,5.2,High,1,5200,5200
Cooking Essentials,Popular Essentials Saunf/Fennel Seeds,4500,2,6,4400,100,FALSE,100,100,1,10000,44,High,0.1,4400,440000
Cooking Essentials,Popular Essentials Bansi Sooji,3500,2,3,3400,500,FALSE,500,100,0.9,250000,6.8,Medium,0.5,3400,1700000
Cooking Essentials,Happilo Premium International Queen Kalmi Dates,24500,29,6,17200,200,FALSE,200,7300,1,40000,86,High,0.2,17200,3440000
Cooking Essentials,Tata Sampann Unpolished Urad Whole,10100,6,4,9400,500,FALSE,500,700,1,250000,18.8,High,0.5,9400,4700000
Cooking Essentials,Popular Essentials Cashew Split,32500,12,6,28300,250,FALSE,250,4200,1,62500,113.2,High,0.25,28300,7075000
Cooking Essentials,Popular Essentials Chana Dal (Un-Polished),6000,10,6,5400,500,FALSE,500,600,0.9,250000,10.8,High,0.5,5400,2700000
Cooking Essentials,Tata Sampann Unpolished Rajma (Chitra),13400,6,6,12500,500,FALSE,500,900,1,250000,25,High,0.5,12500,6250000
Cooking Essentials,Everest Garam Masala,4200,2,2,4100,50,FALSE,50,100,1,2500,82,High,0.05,4100,205000
Cooking Essentials,Everest Kitchen King Masala,7000,14,2,6000,100,FALSE,100,1000,1,10000,60,High,0.1,6000,600000
Cooking Essentials,24 Mantra Organic Cumin,7000,7,2,6500,100,FALSE,100,500,1,10000,65,High,0.1,6500,650000
Cooking Essentials,Nestle Milkmaid,13200,3,6,12800,400,FALSE,400,400,1,160000,32,High,0.4,12800,5120000
Cooking Essentials,Popular Essentials Sona Masouri Steam Rice,6500,9,6,5900,1000,FALSE,1,600,0.8,1000,5.9,High,1,5900,5900
Cooking Essentials,24 Mantra Organic Tur Dal,26000,20,6,20800,1000,FALSE,1,5200,1,1000,20.8,High,1,20800,20800
Cooking Essentials,Gits Gulab Jamun Instant Dessert Mix,9900,10,6,8900,200,FALSE,200,1000,1,40000,44.5,High,0.2,8900,1780000
Cooking Essentials,Popular Essentials Black Masoor Whole (Un-Polished),6500,10,3,5800,500,FALSE,500,700,0.9,250000,11.6,High,0.5,5800,2900000
Cooking Essentials,24 Mantra Organic Peanuts,13500,7,1,12500,500,FALSE,500,1000,1,250000,25,High,0.5,12500,6250000
Cooking Essentials,Everest Hingraj Powder,9000,10,2,8100,50,FALSE,50,900,1,2500,162,High,0.05,8100,405000
Cooking Essentials,Everest Black Pepper Powder,13500,14,6,11500,100,FALSE,100,2000,1,10000,115,High,0.1,11500,1150000
Cooking Essentials,Tata Sampann Masoor Dal Stand,15000,10,4,13400,1000,FALSE,1,1600,0.9,1000,13.4,High,1,13400,13400
Cooking Essentials,24 Mantra Organic Besan,9500,7,5,8800,500,FALSE,500,700,0.9,250000,17.6,High,0.5,8800,4400000
Cooking Essentials,Quaker Oats,19900,7,6,18400,1000,FALSE,1,1500,0.9,1000,18.4,High,1,18400,18400
Cooking Essentials,Saffola Gold Refined Cooking Oil (Jar),48500,7,6,44900,2000,FALSE,2,3600,1,4000,22.45,High,2,44900,89800
Cooking Essentials,Nestle Everyday Dairy Whitener,21000,0,4,21000,400,FALSE,400,0,1,160000,52.5,High,0.4,21000,8400000
Cooking Essentials,24 Mantra Organic Red Poha,7500,8,1,6900,500,FALSE,500,600,0.9,250000,13.8,High,0.5,6900,3450000
Cooking Essentials,Everest Powder - Tea Masala,9800,9,5,8900,100,FALSE,100,900,1,10000,89,High,0.1,8900,890000
Cooking Essentials,Tata Sampann Urad Dal Split,9400,4,6,9000,500,FALSE,500,400,0.9,250000,18,High,0.5,9000,4500000
Cooking Essentials,Popular Essentials Idli Sooji ,3000,6,6,2800,500,FALSE,500,200,0.8,250000,5.6,Medium,0.5,2800,1400000
Cooking Essentials,Popular Essentials Dessicated Coconut,9500,9,6,8600,200,FALSE,200,900,1,40000,43,High,0.2,8600,1720000
Cooking Essentials,Sunfeast Yippee! Mood Masala Noodles,6000,28,3,4300,260,FALSE,260,1700,1,67600,16.54,High,0.26,4300,1118000
Cooking Essentials,Chef's Basket Durum Wheat Elbow Pasta,16000,50,6,8000,500,FALSE,500,8000,1,250000,16,High,0.5,8000,4000000
Cooking Essentials,MTR Breakfast Khatta Meetha Poha Mix,2500,20,6,2000,60,FALSE,60,500,1,3600,33.33,Medium,0.06,2000,120000
Cooking Essentials,Satyam Khobra,11300,10,5,10100,200,FALSE,200,1200,1,40000,50.5,High,0.2,10100,2020000
Cooking Essentials,Betty Crocker Complete Pancake Mix Original,11000,4,6,10500,250,FALSE,500,500,1,125000,42,High,0.25,10500,5250000
Cooking Essentials,Borges Durum Wheat Fusilli Pasta ,25000,0,3,25000,500,FALSE,500,0,1,250000,50,High,0.5,25000,12500000
Cooking Essentials,24 Mantra Organic Green Moong Dal - Split,13500,0,2,13500,500,FALSE,500,0,1,250000,27,High,0.5,13500,6750000
Cooking Essentials,Weikfield Vanilla Flavoured Custard Powder,3700,0,6,3700,100,FALSE,100,0,1,10000,37,Medium,0.1,3700,370000
Cooking Essentials,Tata Sampann Moong Dal Split,18000,1,5,17800,1000,FALSE,200,200,0.9,200000,17.8,High,1,17800,3560000
Cooking Essentials,Tata Sampann Kala Chana,6400,0,5,6400,500,FALSE,500,0,0.9,250000,12.8,High,0.5,6400,3200000
Cooking Essentials,Saffola Soya Chunks Mealmaker,5000,0,2,5000,200,FALSE,200,0,1,40000,25,High,0.2,5000,1000000
Cooking Essentials,24 Mantra Bura Sugar (Demerara),8000,10,6,7200,500,FALSE,500,800,0.9,250000,14.4,High,0.5,7200,3600000
Cooking Essentials,Popular Essentials Green Cardamom (Elaichi),20000,1,6,19800,50,FALSE,50,200,1,2500,396,High,0.05,19800,990000
Cooking Essentials,Hershey's Syrup Delicious Strawberry,9500,0,1,9500,200,FALSE,200,0,1,40000,47.5,High,0.2,9500,1900000
Cooking Essentials,Popular Essentials Anjeer,19000,11,4,16900,100,FALSE,100,2100,1,10000,169,High,0.1,16900,1690000
Cooking Essentials,Popular Essentials Mustard Seeds Rai Small,2000,0,2,2000,100,FALSE,100,0,1,10000,20,Medium,0.1,2000,200000
Cooking Essentials,Weikfield Baking Powder,3300,3,6,3200,100,FALSE,100,100,1,10000,32,Medium,0.1,3200,320000
Cooking Essentials,Dabur Honey Squeezy,18500,9,6,16700,225,FALSE,225,1800,1,50625,74.22,High,0.225,16700,3757500
Cooking Essentials,Tata Sampann High Protein Kali Urad,9100,14,6,7800,500,FALSE,500,1300,0.9,250000,15.6,High,0.5,7800,3900000
Cooking Essentials,Everest Kitchen King Masala,3700,2,6,3600,50,FALSE,50,100,1,2500,72,Medium,0.05,3600,180000
Cooking Essentials,Chef's Basket Durum Wheat Fusilli Pasta,16000,50,6,8000,500,FALSE,500,8000,1,250000,16,High,0.5,8000,4000000
Cooking Essentials,TilSona Til Oil,18000,10,2,16200,500,FALSE,500,1800,1,250000,32.4,High,0.5,16200,8100000
Cooking Essentials,Top Ramen Chicken Noodles,6000,10,1,5400,280,FALSE,280,600,1,78400,19.29,High,0.28,5400,1512000
Cooking Essentials,Everest Chaat Masala,3500,2,1,3400,50,FALSE,50,100,1,2500,68,Medium,0.05,3400,170000
Cooking Essentials,Keya Wonder Red Hot Chilli Flakes,8900,10,2,8000,40,FALSE,40,900,1,1600,200,High,0.04,8000,320000
Cooking Essentials,Popular Essentials White Peas (Un-Polished),8000,10,5,7200,500,FALSE,500,800,0.9,250000,14.4,High,0.5,7200,3600000
Cooking Essentials,Chings Secret Chowmein Hakka Noodles Masala ,4400,0,2,4400,60,FALSE,60,0,1,3600,73.33,High,0.06,4400,264000
Cooking Essentials,Dhara Filtered Groundnut Oil (Jar),105000,1,6,103500,5000,FALSE,5,1500,1,25000,20.7,High,5,103500,517500
Cooking Essentials,Pillsbury Choco Chip Pancake Mix,9900,5,6,9400,165,FALSE,165,500,1,27225,56.97,High,0.165,9400,1551000
Cooking Essentials,Hershey's Caramel Syrup,23000,0,1,23000,623,FALSE,623,0,1,388129,36.92,High,0.623,23000,14329000
Cooking Essentials,Pillsbury Multi Grain Atta,6000,6,3,5600,1000,FALSE,1,400,0.8,1000,5.6,High,1,5600,5600
Cooking Essentials,McCain New Mini Samosa with Cheese Corn Style Filling,12000,1,2,11800,240,FALSE,240,200,1,57600,49.17,High,0.24,11800,2832000
Cooking Essentials,Satyam Puffed Rice Kurmura (A),4300,0,6,4300,200,FALSE,200,0,1,40000,21.5,High,0.2,4300,860000
Cooking Essentials,MTR 3 Min Poha,2500,0,6,2500,60,FALSE,60,0,1,3600,41.67,Medium,0.06,2500,150000
Cooking Essentials,Ching's Manchurian Instant Noodles,1500,0,5,1500,60,FALSE,60,0,1,3600,25,Low,0.06,1500,90000
Cooking Essentials,Everest Pav Bhaji Masala,7000,0,2,7000,100,FALSE,100,0,1,10000,70,High,0.1,7000,700000
Cooking Essentials,Hershey's Chocolate Flavour Syrup,22000,6,6,20500,623,FALSE,680,1500,1,423640,32.91,High,0.623,20500,13940000
Cooking Essentials,Popular Essentials Dhania (Coriander Seeds),5500,16,4,4600,200,FALSE,200,900,1,40000,23,High,0.2,4600,920000
Cooking Essentials,24 Mantra Red Chilly Whole,7000,7,1,6500,100,FALSE,100,500,1,10000,65,High,0.1,6500,650000
Cooking Essentials,Dabur Honey - World's No.1,12000,0,6,12000,250,FALSE,250,0,1,62500,48,High,0.25,12000,3000000
Cooking Essentials,24 Mantra Organic Puffed Rice,4000,2,6,3900,200,FALSE,200,100,1,40000,19.5,High,0.2,3900,780000
Cooking Essentials,24 Mantra Organic Wheat Daliya ,4800,2,2,4700,500,FALSE,500,100,0.9,250000,9.4,High,0.5,4700,2350000
Cooking Essentials,24 Mantra Organic Ragi Flour,6500,20,4,5200,500,FALSE,500,1300,0.9,250000,10.4,High,0.5,5200,2600000
Cooking Essentials,Popular Essentials Cinnamon Whole (Dalchini),3500,5,6,3300,25,FALSE,25,200,1,625,132,Medium,0.025,3300,82500
Cooking Essentials,Sundrop Super Lite Advanced - Sunflower Oil,21500,0,4,21500,1000,FALSE,1,0,1,1000,21.5,High,1,21500,21500
Cooking Essentials,Pillsbury Atta/Godihittu - Chakki Fresh,10200,7,4,9400,2000,FALSE,2,800,0.8,4000,4.7,High,2,9400,18800
Cooking Essentials,Popular Essentials Green Moong Chilka/Chilka (Un-Polished),8500,7,5,7900,500,FALSE,500,600,0.9,250000,15.8,High,0.5,7900,3950000
Cooking Essentials,Popular Essentials HMT Kolam Steam,7500,0,3,7500,1000,FALSE,1,0,0.9,1000,7.5,High,1,7500,7500
Cooking Essentials,Popular Essentials Black Urad Split,8000,10,4,7200,500,FALSE,500,800,0.9,250000,14.4,High,0.5,7200,3600000
Cooking Essentials,Keya Oregano,10900,10,5,9800,9,FALSE,9,1100,1,81,1088.89,High,0.009,9800,88200
Cooking Essentials,Popular Essentials Pink Rajma,10000,10,6,9000,500,FALSE,500,1000,1,250000,18,High,0.5,9000,4500000
Cooking Essentials,Everest Chicken Masala,7400,2,6,7200,100,FALSE,100,200,1,10000,72,High,0.1,7200,720000
Cooking Essentials,Popular Essentials HMT Kolam Steam,37000,10,6,33300,5000,FALSE,5,3700,0.9,25000,6.66,High,5,33300,166500
Cooking Essentials,Everest Shahi Paneer Masala,4200,4,5,4000,50,FALSE,50,200,1,2500,80,High,0.05,4000,200000
Cooking Essentials,Godrej Yummiez Chicken Nuggets,32500,9,1,29300,500,FALSE,500,3200,1,250000,58.6,High,0.5,29300,14650000
Cooking Essentials,Flying Bird Vanilla Essence,3500,2,6,3400,20,FALSE,20,100,1,400,170,Medium,0.02,3400,68000
Cooking Essentials,Everest Sabji Masala,3000,3,6,2900,50,FALSE,50,100,1,2500,58,Medium,0.05,2900,145000
Cooking Essentials,Popular Essentials Californian Almond,69500,32,6,47000,500,FALSE,500,22500,1,250000,94,High,0.5,47000,23500000
Cooking Essentials,Cornitos Cornitos Taco Shells - 4 Inches,11000,20,6,8800,80,FALSE,80,2200,1,6400,110,High,0.08,8800,704000
Cooking Essentials,Everest Rajma Masala,3300,3,5,3200,50,FALSE,50,100,1,2500,64,Medium,0.05,3200,160000
Cooking Essentials,Popular Essentials White Til,4000,5,1,3800,100,FALSE,100,200,1,10000,38,High,0.1,3800,380000
Cooking Essentials,Amul Dark Compound Chocolate Slab,12500,2,6,12200,500,FALSE,500,300,1,250000,24.4,High,0.5,12200,6100000
Cooking Essentials,Mothers Recipe Papad Chana Masala,7900,10,6,7100,200,FALSE,200,800,1,40000,35.5,High,0.2,7100,1420000
Cooking Essentials,Ching's Schezwan Masala Instant Noodles,6000,0,1,6000,240,FALSE,240,0,1,57600,25,High,0.24,6000,1440000
Cooking Essentials,Amul Milk Compound Chocolate Slab,11000,2,6,10700,500,FALSE,500,300,1,250000,21.4,High,0.5,10700,5350000
Cooking Essentials,Eastern Chicken Masala,7000,7,3,6500,100,FALSE,100,500,1,10000,65,High,0.1,6500,650000
Cooking Essentials,Popular Essentials Methi Seeds,2500,0,5,2500,100,FALSE,100,0,1,10000,25,Medium,0.1,2500,250000
Cooking Essentials,Saffola Yummy Masala Noodles ,2000,0,2,2000,46,FALSE,46,0,1,2116,43.48,Medium,0.046,2000,92000
Cooking Essentials,Cadbury Hot Chocolate,17500,5,6,16600,200,FALSE,200,900,1,40000,83,High,0.2,16600,3320000
Cooking Essentials,Ching's Chicken Chilli Masala,1000,0,6,1000,20,FALSE,20,0,1,400,50,Low,0.02,1000,20000
Cooking Essentials,Dabur Keora water - Authentic flavour for Biryani's and Desserts,6200,6,6,5800,250,FALSE,250,400,1,62500,23.2,High,0.25,5800,1450000
Cooking Essentials,Popular Essentials Black Cardamom/Elaichi ,10000,10,6,9000,50,FALSE,50,1000,1,2500,180,High,0.05,9000,450000
Cooking Essentials,Popular Essentials Idli Rice,6000,10,4,5400,1000,FALSE,1,600,0.8,1000,5.4,High,1,5400,5400
Cooking Essentials,Everest Chole Masala,3300,3,1,3200,50,FALSE,50,100,1,2500,64,Medium,0.05,3200,160000
Cooking Essentials,Dabur Hommade Tamarind Paste,4800,6,6,4500,200,FALSE,200,300,1,40000,22.5,High,0.2,4500,900000
Cooking Essentials,"""Maggi Magic Cubes, Vegetarian Masala (Free 2 Cubes Inside)""",3500,2,6,3400,48,FALSE,48,100,1,2304,70.83,Medium,0.048,3400,163200
Cooking Essentials,Popular Essentials Cooking Soda,3000,10,6,2700,200,FALSE,200,300,0.9,40000,13.5,Medium,0.2,2700,540000
Cooking Essentials,RRO Primio Refined Groundnut Oil Pet Bottle,25500,6,2,23900,1000,FALSE,1,1600,1,1000,23.9,High,1,23900,23900
Cooking Essentials,Everest Pani Puri Masala,3100,3,6,3000,50,FALSE,50,100,1,2500,60,Medium,0.05,3000,150000
Cooking Essentials,Nissin Cup Noodles Tangy Tomato,5000,10,2,4500,70,FALSE,70,500,1,4900,64.29,High,0.07,4500,315000
Cooking Essentials,Ching's Veg Manchurian Masala,1000,0,2,1000,20,FALSE,20,0,1,400,50,Low,0.02,1000,20000
Cooking Essentials,Ceres Foods Fish Mustard Instant Liquid Masala,22000,50,6,11000,200,FALSE,200,11000,1,40000,55,High,0.2,11000,2200000
Cooking Essentials,Everest Garam Masala,15800,10,6,14200,200,FALSE,200,1600,1,40000,71,High,0.2,14200,2840000
Cooking Essentials,24 Mantra Organic Jowar Flour,7000,7,6,6500,500,FALSE,500,500,0.9,250000,13,High,0.5,6500,3250000
Cooking Essentials,Maggi Coconut Milkpowder,10000,0,6,10000,100,FALSE,100,0,1,10000,100,High,0.1,10000,1000000
Cooking Essentials,On1y Pepper Grinder,15900,9,1,14400,50,FALSE,50,1500,1,2500,288,High,0.05,14400,720000
Cooking Essentials,Popular Essentials Rice Flour,6000,0,3,6000,1000,FALSE,1,0,0.8,1000,6,High,1,6000,6000
Cooking Essentials,Sunfeast Yippee! Pasta Treat - Sour Cream Onion,2800,10,1,2500,65,FALSE,65,300,1,4225,38.46,Medium,0.065,2500,162500
Cooking Essentials,24 Mantra Organic Brown Sona Masoori Rice,9500,0,6,9500,1000,FALSE,1,0,0.9,1000,9.5,High,1,9500,9500
Cooking Essentials,Happilo Premium Afghani Anjeer,36500,29,2,25600,200,FALSE,200,10900,1,40000,128,High,0.2,25600,5120000
Cooking Essentials,Popular Essentials Chiroti Sooji,3500,2,6,3400,500,FALSE,500,100,0.9,250000,6.8,Medium,0.5,3400,1700000
Cooking Essentials,RRO Til Dil Premium Til Oil Bottle,33000,10,5,29400,1000,FALSE,1,3600,1,1000,29.4,High,1,29400,29400
Cooking Essentials,Popular Essentials Red Rajma,9000,10,6,8100,500,FALSE,500,900,0.9,250000,16.2,High,0.5,8100,4050000
Cooking Essentials,Cornitos Peanut - Premium Salted ,12000,10,6,10800,150,FALSE,150,1200,1,22500,72,High,0.15,10800,1620000
Cooking Essentials,Popular Essentials Black Pepper,10000,10,5,9000,100,FALSE,100,1000,1,10000,90,High,0.1,9000,900000
Cooking Essentials,24 Mantra Organic Tur Dal - Split,13000,7,6,12000,500,FALSE,500,1000,1,250000,24,High,0.5,12000,6000000
Cooking Essentials,Sugarfree Gold Low Calorie Sweetner,6500,6,3,6100,110,FALSE,100,400,1,11000,55.45,High,0.11,6100,610000
Cooking Essentials,Ching's Secret Paneer Chilli Masala,1000,0,2,1000,20,FALSE,20,0,1,400,50,Low,0.02,1000,20000
Cooking Essentials,Dabur Honey ,22000,7,3,20400,500,FALSE,500,1600,1,250000,40.8,High,0.5,20400,10200000
Cooking Essentials,Sunfeast Yippee! Pasta Treat - Sour Cream Onion,2800,17,3,2300,65,FALSE,65,500,1,4225,35.38,Medium,0.065,2300,149500
Cooking Essentials,Everest Tea Masala,5500,9,2,5000,50,FALSE,50,500,1,2500,100,High,0.05,5000,250000
Cooking Essentials,Ching's Paneer Chilli Masala,4400,0,4,4400,60,FALSE,60,0,1,3600,73.33,High,0.06,4400,264000
Cooking Essentials,Sunfeast YiPPee! Magic Masala Noodles,7000,10,3,6300,405,FALSE,405,700,0.9,164025,15.56,High,0.405,6300,2551500
Cooking Essentials,Everest Meat Masala Powder,7400,9,3,6700,100,FALSE,100,700,1,10000,67,High,0.1,6700,670000
Cooking Essentials,Pillsbury Atta With Multigrains Wheat Grains,29500,16,6,24500,5000,FALSE,5,5000,0.8,25000,4.9,High,5,24500,122500
Cooking Essentials,Mother's Recipe Tamarind Paste,5000,2,6,4900,200,FALSE,200,100,1,40000,24.5,High,0.2,4900,980000
Cooking Essentials,Quaker Oats Breakfast Cereals - With Flavour Mix Nutritious Rich Source Of Energy,4900,8,6,4500,200,FALSE,200,400,1,40000,22.5,High,0.2,4500,900000
Cooking Essentials,Popular Essentials Cloves (Lavang),7500,17,6,6200,50,FALSE,50,1300,1,2500,124,High,0.05,6200,310000
Cooking Essentials,Sunfeast Yippee! Power Up Atta Noodles,9600,15,6,8100,280,FALSE,280,1500,1,78400,28.93,High,0.28,8100,2268000
Cooking Essentials,Suhana Paneer Tikka Masala Mix,4000,5,6,3800,50,FALSE,50,200,1,2500,76,High,0.05,3800,190000
Cooking Essentials,24 Mantra Turmeric Powder,3500,2,6,3400,100,FALSE,100,100,1,10000,34,Medium,0.1,3400,340000
Cooking Essentials,24 Mantra Super Grain Quinoa,19000,0,4,19000,500,FALSE,500,0,1,250000,38,High,0.5,19000,9500000
Cooking Essentials,Everest Powder - Egg Curry Masala,4000,2,6,3900,50,FALSE,50,100,1,2500,78,High,0.05,3900,195000
Cooking Essentials,Popular Essentials Pe Shah Jeera ,6000,15,6,5100,50,FALSE,50,900,1,2500,102,High,0.05,5100,255000
Cooking Essentials,24 Mantra Organic Sattu Atta,9500,0,6,9500,500,FALSE,500,0,0.9,250000,19,High,0.5,9500,4750000
Cooking Essentials,Smith & Jones Pasta Masala,4600,0,6,4600,54,FALSE,54,0,1,2916,85.19,High,0.054,4600,248400
Cooking Essentials,Weikfield Vanilla Custard Powder,14200,9,3,12800,500,FALSE,500,1400,1,250000,25.6,High,0.5,12800,6400000
Cooking Essentials,Sugarfree Natura Low Calorie Sweetner ,30000,10,3,27000,42,FALSE,42,3000,1,1764,642.86,High,0.042,27000,1134000
Cooking Essentials,Pillsbury Vanilla Custard Powder,3700,2,6,3600,100,FALSE,100,100,1,10000,36,Medium,0.1,3600,360000
Cooking Essentials,24 Mantra Organic Rajma,14500,0,6,14500,500,FALSE,500,0,1,250000,29,High,0.5,14500,7250000
Cooking Essentials,Popular Essentials Broken Wheat/Daliya,3500,2,6,3400,500,FALSE,500,100,0.9,250000,6.8,Medium,0.5,3400,1700000
Cooking Essentials,Zorabian Chicken Smoked Ham,20500,5,1,19400,250,FALSE,250,1100,1,62500,77.6,High,0.25,19400,4850000
Cooking Essentials,Smith & Jones Peri Peri Masala,9900,0,6,9900,75,FALSE,75,0,1,5625,132,High,0.075,9900,742500
Cooking Essentials,Saffola Veggie Twist Masala Oats,19500,12,2,17100,500,FALSE,500,2400,1,250000,34.2,High,0.5,17100,8550000
Cooking Essentials,Popular Essentials Urad Dal Split (Un-Polished),8500,9,5,7700,500,FALSE,500,800,0.9,250000,15.4,High,0.5,7700,3850000
Cooking Essentials,Weikfield Baking Powder,2200,0,6,2200,50,FALSE,50,0,1,2500,44,Medium,0.05,2200,110000
Cooking Essentials,Popular Essentials Bajra Whole,6500,13,6,5600,1000,FALSE,1,900,0.8,1000,5.6,High,1,5600,5600
Cooking Essentials,Weikfield Veg Jelly Crystals - Strawberry,4500,2,6,4400,90,FALSE,90,100,1,8100,48.89,High,0.09,4400,396000
Cooking Essentials,Weikfield Veg Jelly Crystals - Raspberry,4500,2,6,4400,90,FALSE,90,100,1,8100,48.89,High,0.09,4400,396000
Cooking Essentials,Popular Essentials Masoor Dal Split (Un-Polished),7000,10,4,6300,500,FALSE,500,700,0.9,250000,12.6,High,0.5,6300,3150000
Cooking Essentials,Popular Essentials Ajwain Whole,5000,12,2,4400,100,FALSE,100,600,1,10000,44,High,0.1,4400,440000
Cooking Essentials,Popular Essentials Pista Salted (With Shell),47000,21,5,37100,250,FALSE,250,9900,1,62500,148.4,High,0.25,37100,9275000
Cooking Essentials,The Bake Shop Bread Crumbs,5000,6,3,4700,400,FALSE,400,300,0.9,160000,11.75,High,0.4,4700,1880000
Cooking Essentials,Popular Essentials Horse Gram,4000,10,4,3600,500,FALSE,500,400,0.9,250000,7.2,High,0.5,3600,1800000
Cooking Essentials,Hershey's Chocolate Syrup,9500,0,4,9500,200,FALSE,200,0,1,40000,47.5,High,0.2,9500,1900000
Cooking Essentials,Godrej Yummiez Chilli Chicken Sausages ,16000,10,3,14400,250,FALSE,250,1600,1,62500,57.6,High,0.25,14400,3600000
Cooking Essentials,Everest Kasuri Methi,2500,0,6,2500,25,FALSE,25,0,1,625,100,Medium,0.025,2500,62500
Cooking Essentials,Satyam Makhana,20800,0,6,20800,100,FALSE,100,0,1,10000,208,High,0.1,20800,2080000
Cooking Essentials,Everest Tandoori Chicken Masala,3900,2,5,3800,50,FALSE,50,100,1,2500,76,Medium,0.05,3800,190000
Cooking Essentials,Weikfield Falooda Mix - Kesar Pista,4900,2,3,4800,200,FALSE,200,100,1,40000,24,High,0.2,4800,960000
Cooking Essentials,Weikfield Cocoa Powder,7000,7,6,6500,50,FALSE,50,500,1,2500,130,High,0.05,6500,325000
Cooking Essentials,Pantai Coconut Cream,15000,4,4,14300,400,FALSE,400,700,1,160000,35.75,High,0.4,14300,5720000
Cooking Essentials,Popular Essentials Coriander Seeds,1500,0,5,1500,50,FALSE,50,0,1,2500,30,Low,0.05,1500,75000
Cooking Essentials,Ching's Singapore Curry Instant Noodles,6000,0,4,6000,240,FALSE,240,0,1,57600,25,High,0.24,6000,1440000
Cooking Essentials,Eastern Fish Masala,4800,2,5,4700,100,FALSE,100,100,1,10000,47,High,0.1,4700,470000
Cooking Essentials,Pillsbury Atta/Godihittu - Chakki Fresh,27500,0,6,27500,5000,FALSE,5,0,0.8,25000,5.5,High,5,27500,137500
Cooking Essentials,"Oleev Smart Oil Fortified with VIT A, D, E & K (Pouch)",21500,9,4,19400,1000,FALSE,1,2100,1,1000,19.4,High,1,19400,19400
Cooking Essentials,Everest Dry Ginger Powder,7500,9,4,6800,100,FALSE,100,700,1,10000,68,High,0.1,6800,680000
Cooking Essentials,Pillsbury Cooker Cake Mix - Choco,10000,11,6,8900,159,FALSE,159,1100,1,25281,55.97,High,0.159,8900,1415100
Cooking Essentials,Hersheys Chocolate Almond Syrup,20000,0,2,20000,450,FALSE,450,0,1,202500,44.44,High,0.45,20000,9000000
Cooking Essentials,Satyam Nighties Spices  Chilli Pandi,5600,7,5,5200,100,FALSE,100,400,1,10000,52,High,0.1,5200,520000
Cooking Essentials,Popular Essentials Popular Essential Pista Salted (With Shell),19000,10,6,17100,100,FALSE,100,1900,1,10000,171,High,0.1,17100,1710000
Cooking Essentials,Godrej Yummiez Chicken Punjabi Tikka ,29500,9,6,26600,360,FALSE,360,2900,1,129600,73.89,High,0.36,26600,9576000
Cooking Essentials,Popular Essentials Rozana Sona Masuri Raw Rice,35000,10,5,31200,5000,FALSE,5,3800,0.9,25000,6.24,High,5,31200,156000
Cooking Essentials,24 Mantra Mustard Oil (Cold Pressed) ,35000,10,6,31200,1000,FALSE,1,3800,1,1000,31.2,High,1,31200,31200
Cooking Essentials,24 Mantra Organic Black Pepper,17000,7,6,15700,100,FALSE,100,1300,1,10000,157,High,0.1,15700,1570000
Cooking Essentials,Popular Essentials Green Moong Whole,9000,16,3,7500,500,FALSE,500,1500,0.9,250000,15,High,0.5,7500,3750000
Cooking Essentials,24 Mantra Organic Masoor Dal - Split,9500,7,6,8800,500,FALSE,500,700,0.9,250000,17.6,High,0.5,8800,4400000
Cooking Essentials,Praakritik Organic Natural Rock Salt,6000,6,3,5600,500,FALSE,500,400,0.9,250000,11.2,High,0.5,5600,2800000
Cooking Essentials,24 Mantra Sunflower Oil (Cold Pressed) Pet Bottle,39000,11,5,34700,1000,FALSE,1,4300,1,1000,34.7,High,1,34700,34700
Cooking Essentials,"Ching's Secret Instant Noodles, Hot Garlic",6000,0,4,6000,240,FALSE,240,0,1,57600,25,High,0.24,6000,1440000
Cooking Essentials,Saffola Everyday Peppy Tomato Masala Oats,19500,12,6,17100,500,FALSE,500,2400,1,250000,34.2,High,0.5,17100,8550000
Cooking Essentials,Dabur 100% Pure Honey - Worlds No.1,43000,10,6,38700,1000,FALSE,1,4300,1,1000,38.7,High,1,38700,38700
Cooking Essentials,Popular Essentials Star Anise,7000,10,5,6300,25,FALSE,25,700,1,625,252,High,0.025,6300,157500
Cooking Essentials,Ching's Secret Chicken 65 Masala - Chicken,1000,0,5,1000,20,FALSE,20,0,1,400,50,Low,0.02,1000,20000
Cooking Essentials,Cadbury Cocoa Powder,22300,5,6,21100,150,FALSE,150,1200,1,22500,140.67,High,0.15,21100,3165000
Cooking Essentials,Praakritik Natural Desi Gir Cow A2 Ghee,145000,10,6,130500,540,FALSE,540,14500,1,291600,241.67,High,0.54,130500,70470000
Cooking Essentials,Praakritik Organic Poha,12000,6,5,11200,500,FALSE,500,800,1,250000,22.4,High,0.5,11200,5600000
Cooking Essentials,Praakritik Organic Natural Wild Forest Honey,16000,6,4,15000,200,FALSE,200,1000,1,40000,75,High,0.2,15000,3000000
Cooking Essentials,Popular Essentials Dry Dates (Kharak),14000,15,6,11800,250,FALSE,250,2200,1,62500,47.2,High,0.25,11800,2950000
Cooking Essentials,Popular Essentials Kashmiri Red Rajma,9500,6,4,8900,500,FALSE,500,600,0.9,250000,17.8,High,0.5,8900,4450000
Cooking Essentials,Dabur Hommade - Garlic Paste,5000,6,6,4700,200,FALSE,200,300,1,40000,23.5,High,0.2,4700,940000
Cooking Essentials,Dabur 100% Pure Honey,33000,10,1,29700,400,FALSE,400,3300,1,160000,74.25,High,0.4,29700,11880000
Cooking Essentials,Ching's Schezwan Fried Rice(Miracle Masala),4400,0,5,4400,60,FALSE,60,0,1,3600,73.33,High,0.06,4400,264000
Cooking Essentials,"""Maggi Magic Cubes, Vegetarian Masala""",3500,2,1,3400,40,FALSE,40,100,1,1600,85,Medium,0.04,3400,136000
Cooking Essentials,Everest Tandoori Chicken Masala,7400,9,3,6700,100,FALSE,100,700,1,10000,67,High,0.1,6700,670000
Cooking Essentials,Popular Essentials Red Poha,4500,4,6,4300,500,FALSE,500,200,0.9,250000,8.6,High,0.5,4300,2150000
Cooking Essentials,Everest Kitchen King Masala,14200,9,6,12800,200,FALSE,200,1400,1,40000,64,High,0.2,12800,2560000
Cooking Essentials,Pillsbury Oven Cake Mix - Rich Chocolate,16500,10,5,14700,285,FALSE,285,1800,1,81225,51.58,High,0.285,14700,4189500
Cooking Essentials,Eastern Super Garam Masala,7400,6,2,6900,200,FALSE,200,500,1,40000,34.5,High,0.2,6900,1380000
Cooking Essentials,Maggi Magic Cubes Extra Chicken,4000,2,6,3900,48,FALSE,48,100,1,2304,81.25,High,0.048,3900,187200
Cooking Essentials,Satyam Nighties Spices  Chilli Kashmiri,10200,6,6,9500,100,FALSE,100,700,1,10000,95,High,0.1,9500,950000
Cooking Essentials,Eastern Cumin Powder,4900,2,6,4800,100,FALSE,100,100,1,10000,48,High,0.1,4800,480000
Cooking Essentials,Popular Essentials Urad Gola White(Un-Polished),9000,10,6,8100,500,FALSE,500,900,0.9,250000,16.2,High,0.5,8100,4050000
Cooking Essentials,24 Mantra Organic Chana Dal,9500,6,5,8900,500,FALSE,500,600,0.9,250000,17.8,High,0.5,8900,4450000
Cooking Essentials,Delight Nuts Cashew Roasted & Salted,42500,20,6,34000,200,FALSE,200,8500,1,40000,170,High,0.2,34000,6800000
Cooking Essentials,Popular Essentials Mace/Javitri,9000,10,3,8100,20,FALSE,20,900,1,400,405,High,0.02,8100,162000
Cooking Essentials,Dlicia Whip Topping Bottle,23500,27,5,17100,1000,FALSE,1,6400,1,1000,17.1,High,1,17100,17100
Cooking Essentials,Mother's Recipe Paste Ginger & Garlic,7600,10,4,6800,300,FALSE,300,800,1,90000,22.67,High,0.3,6800,2040000
Cooking Essentials,24 Mantra Groundnut Oil (Cold Pressed) Pet Bottle,41000,10,6,36900,1000,FALSE,1,4100,1,1000,36.9,High,1,36900,36900
Cooking Essentials,Satyam Pulses Masur Dal,8700,6,6,8100,500,FALSE,500,600,0.9,250000,16.2,High,0.5,8100,4050000
Cooking Essentials,Delight Nuts Pista Roasted & Salted,42500,20,6,34000,200,FALSE,200,8500,1,40000,170,High,0.2,34000,6800000
Cooking Essentials,"Top Ramen Noodles, Atta",8000,0,1,8000,280,FALSE,280,0,1,78400,28.57,High,0.28,8000,2240000
Cooking Essentials,Hershey's Cocoa Powder,9500,0,5,9500,70,FALSE,70,0,1,4900,135.71,High,0.07,9500,665000
Cooking Essentials,Praakritik Organic Singhara Atta,24000,6,4,22500,500,FALSE,500,1500,1,250000,45,High,0.5,22500,11250000
Cooking Essentials,Gits Veg Biryani Ready to Eat,11000,10,6,9900,265,FALSE,265,1100,1,70225,37.36,High,0.265,9900,2623500
Cooking Essentials,Delight Nuts Cranberries Sliced ,29900,20,6,23900,200,FALSE,200,6000,1,40000,119.5,High,0.2,23900,4780000
Cooking Essentials,Borges Durum Wheat Pasta Superior Quality,25000,40,6,14900,500,FALSE,500,10100,1,250000,29.8,High,0.5,14900,7450000
Cooking Essentials,Ceres Foods Laal Maas Instant Liquid Masala,22000,50,5,11000,200,FALSE,200,11000,1,40000,55,High,0.2,11000,2200000
Cooking Essentials,Popular Essentials Sattu Atta,9000,12,3,7900,500,FALSE,500,1100,0.9,250000,15.8,High,0.5,7900,3950000
Cooking Essentials,Popular Essentials Mustard Seeds Rai Yellow,2500,0,5,2500,100,FALSE,100,0,1,10000,25,Medium,0.1,2500,250000
Cooking Essentials,Praakritik Organic Extra Virgin Coconut Oil,15000,10,5,13400,100,FALSE,100,1600,1,10000,134,High,0.1,13400,1340000
Cooking Essentials,Praakritik Organic Garlic Powder,11000,1,5,10800,100,FALSE,100,200,1,10000,108,High,0.1,10800,1080000
Cooking Essentials,Sugarfree Gold Low Calorie Sweetner ,12500,5,6,11800,100,FALSE,100,700,1,10000,118,High,0.1,11800,1180000
Cooking Essentials,Aashirvaad Breakfast Instant Mix - Rice Idli,7500,30,6,5200,200,FALSE,200,2300,1,40000,26,High,0.2,5200,1040000
Cooking Essentials,Kitchens Of India Mutter Paneer,13000,4,6,12400,285,FALSE,285,600,1,81225,43.51,High,0.285,12400,3534000
Cooking Essentials,Ching's Secret Veg Manchurian Masala,4400,0,6,4400,60,FALSE,60,0,1,3600,73.33,High,0.06,4400,264000
Cooking Essentials,Popular Essentials Jowa Flour,5000,2,5,4900,500,FALSE,500,100,0.9,250000,9.8,High,0.5,4900,2450000
Cooking Essentials,Everest Shahi Biryani Masala,24500,0,6,24500,200,FALSE,200,0,1,40000,122.5,High,0.2,24500,4900000
Cooking Essentials,Popular Essentials Black Til,5000,6,4,4700,100,FALSE,100,300,1,10000,47,High,0.1,4700,470000
Cooking Essentials,Popular Essentials Pancharatna Dal,8000,10,6,7200,500,FALSE,500,800,0.9,250000,14.4,High,0.5,7200,3600000
Cooking Essentials,Saffola 100% Pure Honey,47500,8,2,43700,1000,FALSE,750,3800,1,750000,43.7,High,1,43700,32775000
Cooking Essentials,Popular Essentials Tamarind,15000,14,6,12800,500,FALSE,500,2200,1,250000,25.6,High,0.5,12800,6400000
Cooking Essentials,Gits Rice Dosa Instant Breakfast Mix,6000,5,5,5700,200,FALSE,200,300,1,40000,28.5,High,0.2,5700,1140000
Cooking Essentials,Popular Essentials Poppy Seeds (Gasagase),28000,7,6,26000,100,FALSE,100,2000,1,10000,260,High,0.1,26000,2600000
Cooking Essentials,Hershey's Hot Chocolate Powder,21000,0,4,21000,250,FALSE,250,0,1,62500,84,High,0.25,21000,5250000
Cooking Essentials,Borges Farfalle Durum Wheat Pasta ,25000,0,5,25000,500,FALSE,500,0,1,250000,50,High,0.5,25000,12500000
Cooking Essentials,Satyam Chilli  Bedgi,8200,10,5,7300,100,FALSE,100,900,1,10000,73,High,0.1,7300,730000
Cooking Essentials,Aashirvaad Instant Mix - Rice Dosa,7500,30,6,5200,200,FALSE,200,2300,1,40000,26,High,0.2,5200,1040000
Cooking Essentials,Hershey's Cocoa - Natural Unsweetened,27000,10,4,24300,225,FALSE,225,2700,1,50625,108,High,0.225,24300,5467500
Cooking Essentials,Weikfield Veg Jelly Crystals - Mango,4500,2,6,4400,90,FALSE,90,100,1,8100,48.89,High,0.09,4400,396000
Cooking Essentials,Praakritik Orrganic Cold Pressed Sesame Oil,13000,10,5,11700,100,FALSE,100,1300,1,10000,117,High,0.1,11700,1170000
Cooking Essentials,Amulya Dairy Whitener ,38000,2,4,37200,1000,FALSE,1,800,1,1000,37.2,High,1,37200,37200
Cooking Essentials,ITC Master Chef Hyderabadi Biryani,7500,30,5,5200,80,FALSE,80,2300,1,6400,65,High,0.08,5200,416000
Cooking Essentials,Flying Bird Butter Scotch Essence,5000,2,6,4900,20,FALSE,20,100,1,400,245,High,0.02,4900,98000
Cooking Essentials,Dabur Hommade - Ginger Paste,5000,6,6,4700,200,FALSE,200,300,1,40000,23.5,High,0.2,4700,940000
Cooking Essentials,Popular Essentials Green Peas (Un-Polished),12000,10,5,10800,500,FALSE,500,1200,1,250000,21.6,High,0.5,10800,5400000
Cooking Essentials,Quaker Oats Pouch,27600,10,6,24800,1500,FALSE,1,2800,0.9,1500,16.53,High,1.5,24800,24800
Cooking Essentials,24 Mantra Organic Urad White Whole,14500,15,4,12200,500,FALSE,500,2300,1,250000,24.4,High,0.5,12200,6100000
Cooking Essentials,Popular Essentials Guntur Chilli Stemless,4000,2,2,3900,100,FALSE,100,100,1,10000,39,High,0.1,3900,390000
Cooking Essentials,Popular Essentials Moth Whole,9000,10,6,8100,500,FALSE,500,900,0.9,250000,16.2,High,0.5,8100,4050000
Cooking Essentials,Keya Pizza Seasoning,10900,17,6,9000,45,FALSE,45,1900,1,2025,200,High,0.045,9000,405000
Cooking Essentials,Keya Piri Piri | Exotic Spices Mix,10900,20,6,8700,80,FALSE,80,2200,1,6400,108.75,High,0.08,8700,696000
Cooking Essentials,24 Mantra Organic Moong Dal,13500,7,6,12500,500,FALSE,500,1000,1,250000,25,High,0.5,12500,6250000
Cooking Essentials,Betty Crocker French Vanilla Cake Mix,31000,10,6,27600,520,FALSE,520,3400,1,270400,53.08,High,0.52,27600,14352000
Cooking Essentials,Delight Nuts Dried Cranberries ,34000,20,6,27200,200,FALSE,200,6800,1,40000,136,High,0.2,27200,5440000
Cooking Essentials,Everest Kesari Milk Masala,20500,0,2,20500,50,FALSE,50,0,1,2500,410,High,0.05,20500,1025000
Cooking Essentials,Tong Garden Salted Cocktail Nuts,29500,9,5,26600,160,FALSE,160,2900,1,25600,166.25,High,0.16,26600,4256000
Cooking Essentials,MTR Uttapam Mix,16500,5,6,15600,500,FALSE,500,900,1,250000,31.2,High,0.5,15600,7800000
Cooking Essentials,Gits Khaman Dhokla Instant Snack Mix,6500,6,6,6100,180,FALSE,180,400,1,32400,33.89,High,0.18,6100,1098000
Cooking Essentials,Happilo Premium 100% Natural Whole Cashews,33500,29,6,23500,200,FALSE,200,10000,1,40000,117.5,High,0.2,23500,4700000
Cooking Essentials,Everest Dry Mango Powder,8000,0,5,8000,100,FALSE,100,0,1,10000,80,High,0.1,8000,800000
Cooking Essentials,Dabur Hommade - Ginger Garlic Past Tub,11000,5,6,10400,400,FALSE,400,600,1,160000,26,High,0.4,10400,4160000
Cooking Essentials,Everest Chicken Masala,14700,10,6,13200,200,FALSE,200,1500,1,40000,66,High,0.2,13200,2640000
Cooking Essentials,Gits Medu Vada Instant Snack Mix,9000,4,6,8600,200,FALSE,200,400,1,40000,43,High,0.2,8600,1720000
Cooking Essentials,Weikfield Drinking Chocolate Powder,6500,10,6,5800,100,FALSE,100,700,1,10000,58,High,0.1,5800,580000
Cooking Essentials,Popular Essentials Regular White Lobia,7000,10,6,6300,500,FALSE,500,700,0.9,250000,12.6,High,0.5,6300,3150000
Cooking Essentials,Puro Healthy Salt Crystal,13500,7,6,12500,1000,FALSE,1,1000,0.9,1000,12.5,High,1,12500,12500
Cooking Essentials,Popular Essentials Premium Jeera Rice,14000,0,5,14000,1000,FALSE,1,0,0.9,1000,14,High,1,14000,14000
Cooking Essentials,Smith & Jones Shahi Paneer Masala Mix,4400,0,6,4400,60,FALSE,60,0,1,3600,73.33,High,0.06,4400,264000
Cooking Essentials,Betty Crocker Mug Treats - Chocolate Mix - Pack of 4,20000,11,6,17800,264,FALSE,264,2200,1,69696,67.42,High,0.264,17800,4699200
Cooking Essentials,Smith & Jones Pasta Masala,6000,10,5,5400,108,FALSE,108,600,1,11664,50,High,0.108,5400,583200
Cooking Essentials,Catch Black Pepper Sprinkler,10000,0,1,10000,50,FALSE,50,0,1,2500,200,High,0.05,10000,500000
Cooking Essentials,Weikfield Cooker Cake Mix - Chocolate,9500,6,6,8900,150,FALSE,150,600,1,22500,59.33,High,0.15,8900,1335000
Cooking Essentials,ITC Master Chef Butter Chicken,7500,30,6,5200,80,FALSE,80,2300,1,6400,65,High,0.08,5200,416000
Cooking Essentials,Masala Oats Masala & Coriander ,19500,9,5,17600,500,FALSE,500,1900,1,250000,35.2,High,0.5,17600,8800000
Cooking Essentials,Smith & Jones Mutter Paneer Masala,4200,0,6,4200,60,FALSE,60,0,1,3600,70,High,0.06,4200,252000
Cooking Essentials,Kitchens of India Dal Bukhara Gravy Mix,11000,30,6,7700,285,FALSE,285,3300,1,81225,27.02,High,0.285,7700,2194500
Cooking Essentials,Popular Essentials Fried Gram (Bengal Gram),7000,10,6,6300,500,FALSE,500,700,0.9,250000,12.6,High,0.5,6300,3150000
Cooking Essentials,Gits Jalebi with Maker Dessert Mix,7500,16,6,6300,100,FALSE,100,1200,1,10000,63,High,0.1,6300,630000
Cooking Essentials,Popular Essentials Soya Beans ,8000,6,6,7500,500,FALSE,500,500,0.9,250000,15,High,0.5,7500,3750000
Cooking Essentials,24 Mantra Organic Roasted Bengal Gram Dal,10500,7,6,9700,500,FALSE,500,800,1,250000,19.4,High,0.5,9700,4850000
Cooking Essentials,Keya Italian Seasoning,10900,10,6,9800,35,FALSE,35,1100,1,1225,280,High,0.035,9800,343000
Cooking Essentials,MTR Idli/Dosa/Chilly Chutney Powder,11500,0,3,11500,200,FALSE,200,0,1,40000,57.5,High,0.2,11500,2300000
Cooking Essentials,Delight Nuts Trail Mix ,39900,25,6,29900,200,FALSE,200,10000,1,40000,149.5,High,0.2,29900,5980000
Cooking Essentials,Praakritik Organic Chilka Moong Dal,12000,10,6,10800,500,FALSE,500,1200,1,250000,21.6,High,0.5,10800,5400000
Cooking Essentials,Smith & Jones Garlic & Herbs Masala Mix,9900,0,6,9900,75,FALSE,75,0,1,5625,132,High,0.075,9900,742500
Cooking Essentials,Eastern Tamarind,6300,0,6,6300,200,FALSE,200,0,1,40000,31.5,High,0.2,6300,1260000
Cooking Essentials,Tong Garden Wasabi Coated Greenpeas Tin,20000,11,6,17800,180,FALSE,180,2200,1,32400,98.89,High,0.18,17800,3204000
Cooking Essentials,Flying Bird Pineapple Artifical Food Essence,5000,2,6,4900,20,FALSE,20,100,1,400,245,High,0.02,4900,98000
Cooking Essentials,Mother's Recipe Tamarind Paste,5000,2,2,4900,200,FALSE,200,100,1,40000,24.5,High,0.2,4900,980000
Cooking Essentials,Japanese Choice Udon Noodles,29500,9,6,26600,250,FALSE,250,2900,1,62500,106.4,High,0.25,26600,6650000
Cooking Essentials,Pantai Coconut Milk,15000,0,4,15000,400,FALSE,400,0,1,160000,37.5,High,0.4,15000,6000000
Cooking Essentials,Praakritik Organic Masoor Dal,13000,10,6,11600,500,FALSE,500,1400,1,250000,23.2,High,0.5,11600,5800000
Cooking Essentials,Popular Essentials Classic Sona Masuri Rice,43000,10,6,38700,5000,FALSE,5,4300,0.9,25000,7.74,High,5,38700,193500
Cooking Essentials,Popular Essentials Salted Murmure ,7000,18,6,5700,400,FALSE,400,1300,0.9,160000,14.25,High,0.4,5700,2280000
Cooking Essentials,Oleev Active Oil (Pouch),26500,9,6,23900,1000,FALSE,1,2600,1,1000,23.9,High,1,23900,23900
Cooking Essentials,Delight Nuts Dried Blueberries ,54000,20,6,43200,150,FALSE,150,10800,1,22500,288,High,0.15,43200,6480000
Cooking Essentials,Popular Essentials Double Beans White,6000,10,6,5400,250,FALSE,250,600,1,62500,21.6,High,0.25,5400,1350000
Cooking Essentials,Delight Nuts Almond Natural ,34900,20,6,27900,200,FALSE,200,7000,1,40000,139.5,High,0.2,27900,5580000
Cooking Essentials,Praakritik Organic Jaggery,16000,6,6,15000,900,FALSE,900,1000,0.9,810000,16.67,High,0.9,15000,13500000
Cooking Essentials,Praakritik Organic Raw Sugar,9000,6,6,8400,500,FALSE,500,600,0.9,250000,16.8,High,0.5,8400,4200000
Cooking Essentials,MTR Masala - Sambar Powder,11500,0,4,11500,200,FALSE,200,0,1,40000,57.5,High,0.2,11500,2300000
Cooking Essentials,RRO Til Dil Premium Til Oil Bottle,17300,6,6,16200,500,FALSE,500,1100,1,250000,32.4,High,0.5,16200,8100000
Cooking Essentials,ITC Master Chef Vegetable Biryani Cooking Paste,7500,30,5,5200,80,FALSE,80,2300,1,6400,65,High,0.08,5200,416000
Cooking Essentials,Jivana Jaggery,10000,0,2,10000,950,FALSE,950,0,0.9,902500,10.53,High,0.95,10000,9500000
Cooking Essentials,Praakritik Organic Besan,17000,6,6,15900,500,FALSE,500,1100,1,250000,31.8,High,0.5,15900,7950000
Cooking Essentials,MTR Instant Gulab Jamun Mix,19500,9,6,17600,500,FALSE,500,1900,1,250000,35.2,High,0.5,17600,8800000
Cooking Essentials,Maggi Magic Cubes Extra Chicken,19900,0,2,19900,240,FALSE,240,0,1,57600,82.92,High,0.24,19900,4776000
Cooking Essentials,On1y Mixed Herbs,9900,0,6,9900,14,FALSE,14,0,1,196,707.14,High,0.014,9900,138600
Cooking Essentials,Popular Essentials Urad Gola Black (Un-Polished),8000,10,6,7200,500,FALSE,500,800,0.9,250000,14.4,High,0.5,7200,3600000
Cooking Essentials,Gits Dessert Mix China Grass Bombay Halwa,5500,0,4,5500,80,FALSE,80,0,1,6400,68.75,High,0.08,5500,440000
Cooking Essentials,Praakritik Organic Basmati Rice,17000,0,5,17000,500,FALSE,500,0,1,250000,34,High,0.5,17000,8500000
Cooking Essentials,Ceres Foods Nalli Nihari Instant Liquid Masala,22000,50,6,11000,200,FALSE,200,11000,1,40000,55,High,0.2,11000,2200000
Cooking Essentials,Borges Canola Oil Pet Bottle,39900,0,6,39900,1000,FALSE,1,0,1,1000,39.9,High,1,39900,39900
Cooking Essentials,Suhana Biryani Masala,6600,0,6,6600,50,FALSE,50,0,1,2500,132,High,0.05,6600,330000
Cooking Essentials,On1y Black Salt Grinder,9900,0,6,9900,100,FALSE,100,0,1,10000,99,High,0.1,9900,990000
Cooking Essentials,Popular Essentials Nylon Til,4000,2,6,3900,100,FALSE,100,100,1,10000,39,High,0.1,3900,390000
Cooking Essentials,Pillsbury Rich Choco Oven Cake Mix - Egg Free,17000,6,6,15900,270,FALSE,270,1100,1,72900,58.89,High,0.27,15900,4293000
Cooking Essentials,Weikfield Tomato Salsa Instant Pasta,2500,0,1,2500,77,FALSE,77,0,1,5929,32.47,Medium,0.077,2500,192500
Cooking Essentials,Praakritik Organic Jowar Atta,11000,6,6,10300,500,FALSE,500,700,1,250000,20.6,High,0.5,10300,5150000
Cooking Essentials,Sugarfree Gold Low Calorie Sweetner ,27000,7,6,25100,50,FALSE,50,1900,1,2500,502,High,0.05,25100,1255000
Cooking Essentials,Epicurea Thai Jasmine Rice,29500,0,4,29500,500,FALSE,500,0,1,250000,59,High,0.5,29500,14750000
Cooking Essentials,Yummiez Chicken Garlic Fingers Pouch,25000,0,5,25000,400,FALSE,400,0,1,160000,62.5,High,0.4,25000,10000000
Cooking Essentials,RRO Primio Refined Groundnut (Jar),49000,11,6,43600,2000,FALSE,2,5400,1,4000,21.8,High,2,43600,87200
Cooking Essentials,Praakritik Organic Tuvar Dal,14000,0,6,14000,500,FALSE,500,0,1,250000,28,High,0.5,14000,7000000
Cooking Essentials,Sugarfree Gold Low Calorie Sweetner,18500,5,3,17500,300,FALSE,300,1000,1,90000,58.33,High,0.3,17500,5250000
Cooking Essentials,Cantina Beans Mexican Beans,25000,14,6,21300,410,FALSE,410,3700,1,168100,51.95,High,0.41,21300,8733000
Cooking Essentials,Pillsbury Oven Cake Mix - Vanilla,17500,10,6,15600,225,FALSE,225,1900,1,50625,69.33,High,0.225,15600,3510000
Cooking Essentials,Hershey's Chocolate Milk Booster,20000,0,6,20000,450,FALSE,450,0,1,202500,44.44,High,0.45,20000,9000000
Cooking Essentials,Popular Essentials Byadagi Chilli Stemless,8000,0,6,8000,100,FALSE,100,0,1,10000,80,High,0.1,8000,800000
Cooking Essentials,Suhana Spice Mix - Chicken Biryani,6600,0,6,6600,50,FALSE,50,0,1,2500,132,High,0.05,6600,330000
Cooking Essentials,Praakritik Organic Yellow Moon Dal,13500,0,6,13500,500,FALSE,500,0,1,250000,27,High,0.5,13500,6750000
Cooking Essentials,Maggi Magic Cubes Extra Chicken,19900,10,6,17900,240,FALSE,240,2000,1,57600,74.58,High,0.24,17900,4296000
Cooking Essentials,Dhara Filtered Groundnut Oil (Jar),105000,0,2,105000,5000,FALSE,5,0,1,25000,21,High,5,105000,525000
Cooking Essentials,24 Mantra Sona Masuri Brown Rice,47500,10,6,42300,5000,FALSE,5,5200,0.9,25000,8.46,High,5,42300,211500
Cooking Essentials,24 Mantra Organic Pancharatna Dal - Split,13000,7,6,12000,500,FALSE,500,1000,1,250000,24,High,0.5,12000,6000000
Cooking Essentials,24 Mantra Organic Cumin Powder,7000,0,6,7000,100,FALSE,100,0,1,10000,70,High,0.1,7000,700000
Cooking Essentials,Popular Essentials Samba Broken Wheat,10000,11,6,8900,500,FALSE,500,1100,1,250000,17.8,High,0.5,8900,4450000
Cooking Essentials,Betty Crocker Chocolate Fudge Cake Mix,29500,0,6,29500,475,FALSE,475,0,1,225625,62.11,High,0.475,29500,14012500
Cooking Essentials,Borges Extra Light Olive Oil Bottle ,260000,46,6,139900,2000,FALSE,2,120100,1,4000,69.95,High,2,139900,279800
Cooking Essentials,Flying Bird Premium Orange Artificial Food Essence,6000,0,6,6000,20,FALSE,20,0,1,400,300,High,0.02,6000,120000
Cooking Essentials,Popular Essentials Red Cherry/Gundu Chilli,9500,0,6,9500,100,FALSE,100,0,1,10000,95,High,0.1,9500,950000
Cooking Essentials,Super Saver Kolam Rice Sortex Clean ,70000,10,3,63000,5000,FALSE,5,7000,0.9,25000,12.6,High,5,63000,315000
Cooking Essentials,Flying Bird Food Essence - Kewra,5000,0,6,5000,20,FALSE,20,0,1,400,250,High,0.02,5000,100000
Cooking Essentials,MTR Vada Breakfast,20000,0,1,20000,500,FALSE,500,0,1,250000,40,High,0.5,20000,10000000
Cooking Essentials,On1y Pasta Seasoning,9900,0,6,9900,30,FALSE,30,0,1,900,330,High,0.03,9900,297000
Cooking Essentials,Praakritik Organic Indrayani Rice,7000,0,6,7000,500,FALSE,500,0,0.9,250000,14,High,0.5,7000,3500000
Cooking Essentials,On1y Pizza Seasoning,9900,0,6,9900,28,FALSE,28,0,1,784,353.57,High,0.028,9900,277200
Cooking Essentials,Kitchens of India Mutter Paneer Mix,12000,30,4,8400,285,FALSE,285,3600,1,81225,29.47,High,0.285,8400,2394000
Cooking Essentials,Aashirvaad Svasti Cow Ghee Tetra Pack,29500,0,6,29500,500,FALSE,500,0,1,250000,59,High,0.5,29500,14750000
Cooking Essentials,Weikfield Cooker Cake Mix - Vanilla,9500,0,6,9500,150,FALSE,150,0,1,22500,63.33,High,0.15,9500,1425000
Cooking Essentials,Praakritik Organic Kapli Wheat Atta,16500,10,6,14700,1000,FALSE,1,1800,0.9,1000,14.7,High,1,14700,14700
Cooking Essentials,Epicurea Sushi Rice,29500,0,6,29500,500,FALSE,500,0,1,250000,59,High,0.5,29500,14750000
Cooking Essentials,Sugarfree Natural Green Stevia Leaves Zero Calorie,7500,0,2,7500,100,FALSE,100,0,1,10000,75,High,0.1,7500,750000
Cooking Essentials,Smith & Jones Italian Spices Masala Mix,9900,0,6,9900,75,FALSE,75,0,1,5625,132,High,0.075,9900,742500
Cooking Essentials,Satyam Nighties Spices  Chilli Bore,8900,10,6,8000,100,FALSE,100,900,1,10000,80,High,0.1,8000,800000
Cooking Essentials,Weikfield Veg Jelly Crystals - Orange,4500,2,6,4400,90,FALSE,90,100,1,8100,48.89,High,0.09,4400,396000
Cooking Essentials,Praakritik Organic Jumbo Rolled Oats,19000,11,6,16900,500,FALSE,500,2100,1,250000,33.8,High,0.5,16900,8450000
Cooking Essentials,On1y Sea Salt Grinder,8900,0,6,8900,100,FALSE,100,0,1,10000,89,High,0.1,8900,890000
Cooking Essentials,Delight Nuts Berries Mix ,39900,20,6,31900,200,FALSE,200,8000,1,40000,159.5,High,0.2,31900,6380000
Cooking Essentials,Everest Kesari Milk Masala,20500,0,6,20500,50,FALSE,20,0,1,1000,410,High,0.05,20500,410000
Cooking Essentials,Praakritik Organic Ginger Powder,13900,10,6,12500,100,FALSE,100,1400,1,10000,125,High,0.1,12500,1250000
Cooking Essentials,Suhana Mutton Gravy Mix,4500,0,4,4500,80,FALSE,80,0,1,6400,56.25,High,0.08,4500,360000
Cooking Essentials,On1y Salad Seasoning Grinder,13900,0,6,13900,45,FALSE,45,0,1,2025,308.89,High,0.045,13900,625500
Cooking Essentials,Figaro Pure Olive Oil,32500,8,1,29900,200,FALSE,200,2600,1,40000,149.5,High,0.2,29900,5980000
Cooking Essentials,Madhur Sugar,6000,6,0,5600,1000,TRUE,1,400,0.8,1000,5.6,High,1,5600,5600
Cooking Essentials,Amul Fresh Cream,6300,0,0,6300,250,TRUE,250,0,1,62500,25.2,High,0.25,6300,1575000
Cooking Essentials,Madhur Pure And Hygienic Sugar,29500,9,0,26600,5000,TRUE,5,2900,0.8,25000,5.32,High,5,26600,133000
Cooking Essentials,Satyam Poha Jada,3500,8,0,3200,500,TRUE,500,300,0.9,250000,6.4,Medium,0.5,3200,1600000
Cooking Essentials,Aashirvaad Superior MP Whole Wheat Atta,5300,1,0,5200,1000,TRUE,1,100,0.8,1000,5.2,High,1,5200,5200
Cooking Essentials,Fortune Soyabean Oil,21000,13,0,18100,1000,TRUE,1,2900,1,1000,18.1,High,1,18100,18100
Cooking Essentials,Maggi Masala Ae Magic,5800,6,0,5400,72,TRUE,72,400,1,5184,75,High,0.072,5400,388800
Cooking Essentials,Aashirvaad Iodised Salt ,2200,13,0,1900,1000,TRUE,1,300,0.5,1000,1.9,Medium,1,1900,1900
Cooking Essentials,Maggi 2-Minute Instant Noodles - Masala,4400,0,0,4400,280,TRUE,280,0,0.9,78400,15.71,High,0.28,4400,1232000
Cooking Essentials,Popular Essentials Phool Makhana (Jumbo Size),15000,14,0,12800,100,TRUE,100,2200,1,10000,128,High,0.1,12800,1280000
Cooking Essentials,Aashirvaad Atta With Mutigrains,31500,8,0,28700,5000,TRUE,5,2800,0.8,25000,5.74,High,5,28700,143500
Cooking Essentials,Tata Sampann Poha,4400,6,0,4100,500,TRUE,500,300,0.9,250000,8.2,High,0.5,4100,2050000
Cooking Essentials,Fortune Besan Flour,12000,0,0,12000,1000,TRUE,1,0,0.9,1000,12,High,1,12000,12000
Cooking Essentials,Popular Essentials Toor Dal (Un-Polished),8000,7,0,7400,500,TRUE,500,600,0.9,250000,14.8,High,0.5,7400,3700000
Cooking Essentials,Everest Tikhalal Hot & Red Chilly Powder,4700,2,0,4600,100,TRUE,100,100,1,10000,46,High,0.1,4600,460000
Cooking Essentials,Popular Essentials Chia Seeds,5000,2,0,4900,100,TRUE,100,100,1,10000,49,High,0.1,4900,490000
Cooking Essentials,Tata Sampann Unpolished Toor Dal/Arhar Dal,17900,1,0,17700,1000,TRUE,200,200,0.9,200000,17.7,High,1,17700,3540000
Cooking Essentials,Everest Coriander Powder,3200,3,0,3100,100,TRUE,100,100,1,10000,31,Medium,0.1,3100,310000
Cooking Essentials,Satyam Thin Poha Patla,3800,7,0,3500,500,TRUE,500,300,0.9,250000,7,Medium,0.5,3500,1750000
Cooking Essentials,Popular Essentials Sona Masouri Raw Rice,7500,0,0,7500,1000,TRUE,1,0,0.9,1000,7.5,High,1,7500,7500
Cooking Essentials,Tata Sampann High Protien Chana Dal - Split,6400,0,0,6400,500,TRUE,500,0,0.9,250000,12.8,High,0.5,6400,3200000
Cooking Essentials,Satyam Singdana ,11900,6,0,11100,500,TRUE,500,800,1,250000,22.2,High,0.5,11100,5550000
Cooking Essentials,Tata Sampann Moong Chilka ,8800,6,0,8200,500,TRUE,500,600,0.9,250000,16.4,High,0.5,8200,4100000
Cooking Essentials,Tata Sampann High Protien Toor Dal - Split,9100,2,0,8900,500,TRUE,500,200,0.9,250000,17.8,High,0.5,8900,4450000
Cooking Essentials,Ching's Chow Mein Hakka Noodles Masala,1000,0,0,1000,20,TRUE,20,0,1,400,50,Low,0.02,1000,20000
Cooking Essentials,Everest Chat Masala,6500,9,0,5900,100,TRUE,100,600,1,10000,59,High,0.1,5900,590000
Cooking Essentials,Popular Essentials Black Brown Chana (Un-Polished),5500,9,0,5000,500,TRUE,500,500,0.9,250000,10,High,0.5,5000,2500000
Cooking Essentials,Dabur Ginger Garlic Paste,5000,6,0,4700,200,TRUE,200,300,1,40000,23.5,High,0.2,4700,940000
Cooking Essentials,Ching's Secret Veg Hakka Noodles,10700,0,0,10700,600,TRUE,600,0,0.9,360000,17.83,High,0.6,10700,6420000
Cooking Essentials,Saffola Oats 100 % Natural,1500,0,0,1500,38,TRUE,38,0,1,1444,39.47,Low,0.038,1500,57000
Cooking Essentials,Everest Kashmiri Lal Chilli Powder,31000,10,0,27900,500,TRUE,500,3100,1,250000,55.8,High,0.5,27900,13950000
Cooking Essentials,Popular Essentials Black Raisins Seedless,6000,10,0,5400,100,TRUE,100,600,1,10000,54,High,0.1,5400,540000
Cooking Essentials,Daawat Rozana Super Basmati Rice,7900,0,0,7900,1000,TRUE,1,0,0.9,1000,7.9,High,1,7900,7900
Cooking Essentials,Everest Cumin Powder (Jeera),3000,3,0,2900,50,TRUE,50,100,1,2500,58,Medium,0.05,2900,145000
Cooking Essentials,Everest Sambhar Masala,3400,2,0,3300,50,TRUE,50,100,1,2500,66,Medium,0.05,3300,165000
Cooking Essentials,Maggi Chilly Chow Cuppa Noodles,5000,0,0,5000,70,TRUE,70,0,1,4900,71.43,High,0.07,5000,350000
Cooking Essentials,Popular Essentials Mustard Seeds Rai Big,2000,0,0,2000,100,TRUE,100,0,1,10000,20,Medium,0.1,2000,200000
Cooking Essentials,Patanjali Cow's Ghee,56500,0,0,56500,1000,TRUE,1,0,1,1000,56.5,High,1,56500,56500
Cooking Essentials,Everest Amchur Powder,4200,2,0,4100,50,TRUE,50,100,1,2500,82,High,0.05,4100,205000
Cooking Essentials,Daawat Super Basmati Rice,18500,8,0,16900,1000,TRUE,1,1600,0.9,1000,16.9,High,1,16900,16900
Cooking Essentials,Popular Essentials Sabudana,6000,10,0,5400,500,TRUE,500,600,0.9,250000,10.8,High,0.5,5400,2700000
Cooking Essentials,Popular Essentials Brown Sugar,4000,0,0,4000,500,TRUE,500,0,0.9,250000,8,High,0.5,4000,2000000
Cooking Essentials,Everest Coriander Powder,7000,10,0,6300,200,TRUE,200,700,1,40000,31.5,High,0.2,6300,1260000
Cooking Essentials,Sunfeast Yippee! Magic Masala Noodles,4800,6,0,4500,240,TRUE,240,300,1,57600,18.75,High,0.24,4500,1080000
Cooking Essentials,Tata Tea Gold,3500,0,0,3500,100,TRUE,200,0,1,20000,35,Medium,0.1,3500,700000
Cooking Essentials,Daawat Rozana Gold Basmati Rice,9000,1,0,8900,1000,TRUE,1,100,0.9,1000,8.9,High,1,8900,8900
Cooking Essentials,Top Ramen Masala,9100,9,0,8200,560,TRUE,560,900,0.9,313600,14.64,High,0.56,8200,4592000
Cooking Essentials,Everest Turmeric Powder,6700,10,0,6000,200,TRUE,200,700,1,40000,30,High,0.2,6000,1200000
Cooking Essentials,Popular Essentials Buckwheat Flour (Kuttu Atta),12500,9,0,11300,500,TRUE,500,1200,1,250000,22.6,High,0.5,11300,5650000
Cooking Essentials,Keya Italian Pizza Oregano,10900,11,0,9700,80,TRUE,80,1200,1,6400,121.25,High,0.08,9700,776000
Cooking Essentials,Chef's Basket Durum Wheat Penne Pasta,16000,50,0,8000,500,TRUE,500,8000,1,250000,16,High,0.5,8000,4000000
Cooking Essentials,Tata Sampann Kala Chana,12500,0,0,12500,1000,TRUE,1,0,0.9,1000,12.5,High,1,12500,12500
Cooking Essentials,India Gate Basmati Rice,21000,0,0,21000,1000,TRUE,1,0,1,1000,21,High,1,21000,21000
Cooking Essentials,24 Mantra Organic Whole Wheat Atta,6400,7,0,5900,1000,TRUE,1,500,0.8,1000,5.9,High,1,5900,5900
Cooking Essentials,Zorabian Chicken Kheema Parathas,19000,0,0,19000,300,TRUE,300,0,1,90000,63.33,High,0.3,19000,5700000
Cooking Essentials,Sunfeast Pasta Treat Pack of Tomato Cheese,2800,17,0,2300,65,TRUE,65,500,1,4225,35.38,Medium,0.065,2300,149500
Cooking Essentials,Sugarlite 50% Less Calories Sugar Pouch,9900,40,0,5900,500,TRUE,500,4000,0.9,250000,11.8,High,0.5,5900,2950000
Cooking Essentials,Popular Essentials Sabja/Basil Seeds,6000,15,0,5100,100,TRUE,100,900,1,10000,51,High,0.1,5100,510000
Cooking Essentials,Patanjali Pure Honey,9500,0,0,9500,250,TRUE,250,0,1,62500,38,High,0.25,9500,2375000
Cooking Essentials,Weikfield Falooda Mix - Mango,4900,2,0,4800,200,TRUE,200,100,1,40000,24,High,0.2,4800,960000
Cooking Essentials,Pro Nature Organic Sonamasoori Brown Rice,10200,7,0,9400,1000,TRUE,1,800,0.9,1000,9.4,High,1,9400,9400
Cooking Essentials,Maggi Special Masala Spicy Yummy Noodles,7200,0,0,7200,280,TRUE,280,0,1,78400,25.71,High,0.28,7200,2016000
Cooking Essentials,Godrej Yummiez Chicken Breakfast Salami,15000,4,0,14300,250,TRUE,250,700,1,62500,57.2,High,0.25,14300,3575000
Cooking Essentials,Everest Saffron Kesar,12000,0,0,12000,1,TRUE,0,0,1,0,12000,High,0.001,12000,0
Munchies,Maggi 2 Minute Masala Noodles,1200,0,6,1200,70,FALSE,70,0,0.9,4900,17.14,Low,0.07,1200,84000
Munchies,iD Idli & Dosa Batter ,8000,15,6,6800,1000,FALSE,1,1200,0.9,1000,6.8,High,1,6800,6800
Munchies,Tata Salt,2400,0,6,2400,1000,FALSE,1,0,0.6,1000,2.4,Medium,1,2400,2400
Munchies,Arden Eggs White,9700,0,4,9700,696,FALSE,12,0,0.9,8352,13.94,High,0.696,9700,116400
Munchies,Arden Eggs White,6500,15,4,5500,348,FALSE,6,1000,0.9,2088,15.8,High,0.348,5500,33000
Munchies,Fortune Sunlite Refined Sunflower (Pouch),23000,4,6,21900,1000,FALSE,1,1100,1,1000,21.9,High,1,21900,21900
Munchies,Aashirvaad Superior MP Atta,25000,2,6,24500,5000,FALSE,5,500,0.8,25000,4.9,High,5,24500,122500
Munchies,Amul Pure Ghee (Pouch),25500,2,6,24900,500,FALSE,500,600,1,250000,49.8,High,0.5,24900,12450000
Munchies,Arden Eggs Brown,8500,7,4,7900,348,FALSE,6,600,1,2088,22.7,High,0.348,7900,47400
Munchies,Tata Salt Lite,4000,10,6,3600,1000,FALSE,1,400,0.8,1000,3.6,High,1,3600,3600
Munchies,Saffola Gold Oil (Pouch),21500,0,6,21500,1000,FALSE,1,0,1,1000,21.5,High,1,21500,21500
Munchies,Fortune Sunlite Refined Sunflower (Jar),92500,0,6,92500,5000,FALSE,5,0,0.9,25000,18.5,High,5,92500,462500
Munchies,Fortune Rice Bran (Pouch),22500,11,6,19900,1000,FALSE,1,2600,1,1000,19.9,High,1,19900,19900
Munchies,Saffola Active Oil,21000,0,6,21000,1000,FALSE,1,0,1,1000,21,High,1,21000,21000
Munchies,Amul Pure Ghee (Pouch),50500,1,2,49900,1000,FALSE,1,600,1,1000,49.9,High,1,49900,49900
Munchies,Aashirvaad Atta,46000,13,6,39900,10000,FALSE,10,6100,0.8,100000,3.99,High,10,39900,399000
Munchies,Popular Essentials Toor Dal (Un-Polished),16000,6,4,14900,1000,FALSE,1,1100,0.9,1000,14.9,High,1,14900,14900
Munchies,Amul Ghee (Tin),52000,2,6,50900,1000,FALSE,1,1100,1,1000,50.9,High,1,50900,50900
Munchies,Amul Fresh Cream,19700,3,3,19100,1000,FALSE,1,600,0.9,1000,19.1,High,1,19100,19100
Munchies,Popular Essentials Pure Jaggery,5000,2,6,4900,450,FALSE,450,100,0.9,202500,10.89,High,0.45,4900,2205000
Munchies,Aashirvaad Multigrain Atta,6400,3,2,6200,1000,FALSE,1,200,0.8,1000,6.2,High,1,6200,6200
Munchies,Fortune Soyabean Oil,100500,0,6,99900,5000,FALSE,5,600,1,25000,19.98,High,5,99900,499500
Munchies,Popular Essentials Sunflower Seeds,2500,0,6,2500,50,FALSE,50,0,1,2500,50,Medium,0.05,2500,125000
Munchies,Tata Sampann kabuli chana,18500,1,4,18300,1000,FALSE,500,200,0.9,500000,18.3,High,1,18300,9150000
Munchies,Dhara Groundnut Oil (Pouch),23000,11,6,20300,1000,FALSE,1,2700,1,1000,20.3,High,1,20300,20300
Munchies,Dhara Health Refined Sun Flower Oil Jar,120000,18,6,98400,5000,FALSE,5,21600,1,25000,19.68,High,5,98400,492000
Munchies,24 Mantra Organic Jaggery Powder,8000,15,6,6800,500,FALSE,500,1200,0.9,250000,13.6,High,0.5,6800,3400000
Munchies,Tata Sampann High Protien Kabuli Chana,9400,0,1,9400,500,FALSE,500,0,0.9,250000,18.8,High,0.5,9400,4700000
Munchies,Dhara Kachi Ghani Mustard Oil Jar,125000,8,6,114300,5000,FALSE,5,10700,1,25000,22.86,High,5,114300,571500
Munchies,D'lecta Dairy Cream,5400,5,6,5100,200,FALSE,200,300,1,40000,25.5,High,0.2,5100,1020000
Munchies,Ching's Secret Instant Hot Garlic Noodles,1500,0,3,1500,60,FALSE,60,0,1,3600,25,Low,0.06,1500,90000
Munchies,Dabur Ginger Garlic Paste,2500,8,3,2300,100,FALSE,100,200,1,10000,23,Medium,0.1,2300,230000
Munchies,Ching's Secret Instant Schezwan Noodles,1500,0,6,1500,60,FALSE,60,0,1,3600,25,Low,0.06,1500,90000
Munchies,Gowardhan Ghee/Tuppa Jar,31500,1,6,30900,500,FALSE,500,600,1,250000,61.8,High,0.5,30900,15450000
Munchies,Tata Sampann Unpolished Moong Dal ,9200,4,4,8800,500,FALSE,500,400,0.9,250000,17.6,High,0.5,8800,4400000
Munchies,Aashirvaad Select Atta,6400,0,6,6400,1000,FALSE,1,0,0.8,1000,6.4,High,1,6400,6400
Munchies,Popular Essentials Misri Dana (Diamond Sugar) ,1500,0,4,1500,100,FALSE,100,0,0.9,10000,15,Low,0.1,1500,150000
Munchies,Gowardhan Ghee Jar,59800,3,6,57900,1000,FALSE,1,1900,1,1000,57.9,High,1,57900,57900
Munchies,Top Ramen  Noodles Curry Veg Pouch,2000,0,1,2000,70,FALSE,70,0,1,4900,28.57,Medium,0.07,2000,140000
Munchies,Popular Essentials Refined Sugar,6000,0,6,6000,1000,FALSE,1,0,0.8,1000,6,High,1,6000,6000
Munchies,Fortune Kachi Ghani Mustard Oil Bottle,21600,7,6,19900,1000,FALSE,1,1700,1,1000,19.9,High,1,19900,19900
Munchies,Saffola Veggie Twist Masala Oats,1500,0,6,1500,38,FALSE,38,0,1,1444,39.47,Low,0.038,1500,57000
Munchies,Satyam Puffed Rice Kurmura (R),2300,0,6,2300,200,FALSE,200,0,0.9,40000,11.5,Medium,0.2,2300,460000
Munchies,Quaker Oats,7900,0,2,7900,400,FALSE,400,0,0.9,160000,19.75,High,0.4,7900,3160000
Munchies,Aashirvaad Select Sharbati Atta,31500,10,6,28300,5000,FALSE,5,3200,0.8,25000,5.66,High,5,28300,141500
Munchies,Popular Essentials Refined Sugar,29500,10,6,26500,5000,FALSE,5,3000,0.8,25000,5.3,High,5,26500,132500
Munchies,Gowardhan Cow Ghee Pouch,57900,10,6,52100,1000,FALSE,1,5800,1,1000,52.1,High,1,52100,52100
Munchies,Dhara Nourish Refined Sunflower Oil Pouch,21000,5,6,19900,1000,FALSE,1,1100,1,1000,19.9,High,1,19900,19900
Munchies,Parachute Oil ,4000,7,3,3700,100,FALSE,100,300,1,10000,37,High,0.1,3700,370000
Munchies,Popular Essentials Plain Puffed Rice (Murmura/Muri),1800,0,6,1800,100,FALSE,100,0,0.9,10000,18,Low,0.1,1800,180000
Munchies,Amul Mithai Mate Condensed Sweetened Milk,5600,3,4,5400,200,FALSE,200,200,1,40000,27,High,0.2,5400,1080000
Munchies,Saffola Gold (Jar),124000,0,6,124000,5000,FALSE,5,0,1,25000,24.8,High,5,124000,620000
Munchies,McCain New Mini Samosa with Cheese Pizza Style Filling,12000,1,3,11800,240,FALSE,240,200,1,57600,49.17,High,0.24,11800,2832000
Munchies,Fortune Rice Bran Health Oil (Jar),105000,1,6,103900,5000,FALSE,5,1100,1,25000,20.78,High,5,103900,519500
Munchies,Arden Desi Eggs,11000,13,4,9500,348,FALSE,6,1500,1,2088,27.3,High,0.348,9500,57000
Munchies,Fortune Rozana Basmati Rice,58500,21,6,46200,5000,FALSE,5,12300,0.9,25000,9.24,High,5,46200,231000
Munchies,Fortune Biriyani Special Basmati Rice,17500,0,5,17500,1000,FALSE,1,0,0.9,1000,17.5,High,1,17500,17500
Munchies,Everest Garam Masala,7800,7,5,7200,100,FALSE,100,600,1,10000,72,High,0.1,7200,720000
Munchies,Popular Essentials Pumpkin Seeds,9000,16,6,7500,100,FALSE,100,1500,1,10000,75,High,0.1,7500,750000
Munchies,Fortune Soya Health Refined Soybean Oil,21000,1,2,20600,1000,FALSE,1,400,1,1000,20.6,High,1,20600,20600
Munchies,Gowardhan Pure Ghee Pouch,29500,4,6,28100,500,FALSE,500,1400,1,250000,56.2,High,0.5,28100,14050000
Munchies,Popular Essentials Jeera/Cumin Seeds,4000,5,3,3800,100,FALSE,100,200,1,10000,38,High,0.1,3800,380000
Munchies,Weikfield Baking Soda,3000,3,6,2900,100,FALSE,100,100,1,10000,29,Medium,0.1,2900,290000
Munchies,Everest Pav Bhaji Masala,3700,10,4,3300,50,FALSE,50,400,1,2500,66,Medium,0.05,3300,165000
Munchies,Tata Sampann Unpolished Chana Dal,9500,6,2,8900,1000,FALSE,500,600,0.9,500000,8.9,High,1,8900,4450000
Munchies,Amul Mithai Mate EOE Tin,11200,2,6,10900,400,FALSE,400,300,1,160000,27.25,High,0.4,10900,4360000
Munchies,Pillsbury Chakki Fresh Atta,45000,16,6,37500,10000,FALSE,10,7500,0.8,100000,3.75,High,10,37500,375000
Munchies,Everest Chicken Masala,3900,2,1,3800,50,FALSE,50,100,1,2500,76,Medium,0.05,3800,190000
Munchies,Dhara Life Refined Ricebran Oil (Pouch),20500,7,6,19000,1000,FALSE,1,1500,1,1000,19,High,1,19000,19000
Munchies,Borges Extra Virgin Olive Oil,40000,25,1,29900,250,FALSE,250,10100,1,62500,119.6,High,0.25,29900,7475000
Munchies,Everest Shahi Biryani Masala,7000,14,6,6000,50,FALSE,50,1000,1,2500,120,High,0.05,6000,300000
Munchies,Popular Essentials Californian Almond,35000,28,6,25100,250,FALSE,250,9900,1,62500,100.4,High,0.25,25100,6275000
Munchies,Popular Essentials Ajwain Whole,2500,0,4,2500,50,FALSE,50,0,1,2500,50,Medium,0.05,2500,125000
Munchies,Everest Tikhalal Chilli Powder,23500,9,6,21200,500,FALSE,500,2300,1,250000,42.4,High,0.5,21200,10600000
Munchies,Popular Essentials Kabuli Chana Regular,8500,9,6,7700,500,FALSE,500,800,0.9,250000,15.4,High,0.5,7700,3850000
Munchies,Pillsbury Chakki Fresh Atta,5200,0,4,5200,1000,FALSE,1,0,0.8,1000,5.2,High,1,5200,5200
Munchies,Popular Essentials Saunf/Fennel Seeds,4500,2,6,4400,100,FALSE,100,100,1,10000,44,High,0.1,4400,440000
Munchies,Popular Essentials Bansi Sooji,3500,2,3,3400,500,FALSE,500,100,0.9,250000,6.8,Medium,0.5,3400,1700000
Munchies,Happilo Premium International Queen Kalmi Dates,24500,29,6,17200,200,FALSE,200,7300,1,40000,86,High,0.2,17200,3440000
Munchies,Tata Sampann Unpolished Urad Whole,10100,6,4,9400,500,FALSE,500,700,1,250000,18.8,High,0.5,9400,4700000
Munchies,Popular Essentials Cashew Split,32500,12,6,28300,250,FALSE,250,4200,1,62500,113.2,High,0.25,28300,7075000
Munchies,Popular Essentials Chana Dal (Un-Polished),6000,10,6,5400,500,FALSE,500,600,0.9,250000,10.8,High,0.5,5400,2700000
Munchies,Tata Sampann Unpolished Rajma (Chitra),13400,6,6,12500,500,FALSE,500,900,1,250000,25,High,0.5,12500,6250000
Munchies,Everest Garam Masala,4200,2,2,4100,50,FALSE,50,100,1,2500,82,High,0.05,4100,205000
Munchies,Everest Kitchen King Masala,7000,14,2,6000,100,FALSE,100,1000,1,10000,60,High,0.1,6000,600000
Munchies,24 Mantra Organic Cumin,7000,7,2,6500,100,FALSE,100,500,1,10000,65,High,0.1,6500,650000
Munchies,Nestle Milkmaid,13200,3,6,12800,400,FALSE,400,400,1,160000,32,High,0.4,12800,5120000
Munchies,Popular Essentials Sona Masouri Steam Rice,6500,9,6,5900,1000,FALSE,1,600,0.8,1000,5.9,High,1,5900,5900
Munchies,24 Mantra Organic Tur Dal,26000,20,6,20800,1000,FALSE,1,5200,1,1000,20.8,High,1,20800,20800
Munchies,Gits Gulab Jamun Instant Dessert Mix,9900,10,6,8900,200,FALSE,200,1000,1,40000,44.5,High,0.2,8900,1780000
Munchies,Popular Essentials Black Masoor Whole (Un-Polished),6500,10,3,5800,500,FALSE,500,700,0.9,250000,11.6,High,0.5,5800,2900000
Munchies,24 Mantra Organic Peanuts,13500,7,1,12500,500,FALSE,500,1000,1,250000,25,High,0.5,12500,6250000
Munchies,Everest Hingraj Powder,9000,10,2,8100,50,FALSE,50,900,1,2500,162,High,0.05,8100,405000
Munchies,Everest Black Pepper Powder,13500,14,6,11500,100,FALSE,100,2000,1,10000,115,High,0.1,11500,1150000
Munchies,Tata Sampann Masoor Dal Stand,15000,10,4,13400,1000,FALSE,1,1600,0.9,1000,13.4,High,1,13400,13400
Munchies,24 Mantra Organic Besan,9500,7,5,8800,500,FALSE,500,700,0.9,250000,17.6,High,0.5,8800,4400000
Munchies,Quaker Oats,19900,7,6,18400,1000,FALSE,1,1500,0.9,1000,18.4,High,1,18400,18400
Munchies,Saffola Gold Refined Cooking Oil (Jar),48500,7,6,44900,2000,FALSE,2,3600,1,4000,22.45,High,2,44900,89800
Munchies,Nestle Everyday Dairy Whitener,21000,0,4,21000,400,FALSE,400,0,1,160000,52.5,High,0.4,21000,8400000
Munchies,24 Mantra Organic Red Poha,7500,8,1,6900,500,FALSE,500,600,0.9,250000,13.8,High,0.5,6900,3450000
Munchies,Everest Powder - Tea Masala,9800,9,5,8900,100,FALSE,100,900,1,10000,89,High,0.1,8900,890000
Munchies,Tata Sampann Urad Dal Split,9400,4,6,9000,500,FALSE,500,400,0.9,250000,18,High,0.5,9000,4500000
Munchies,Popular Essentials Idli Sooji ,3000,6,6,2800,500,FALSE,500,200,0.8,250000,5.6,Medium,0.5,2800,1400000
Munchies,Popular Essentials Dessicated Coconut,9500,9,6,8600,200,FALSE,200,900,1,40000,43,High,0.2,8600,1720000
Munchies,Sunfeast Yippee! Mood Masala Noodles,6000,28,3,4300,260,FALSE,260,1700,1,67600,16.54,High,0.26,4300,1118000
Munchies,Chef's Basket Durum Wheat Elbow Pasta,16000,50,6,8000,500,FALSE,500,8000,1,250000,16,High,0.5,8000,4000000
Munchies,MTR Breakfast Khatta Meetha Poha Mix,2500,20,6,2000,60,FALSE,60,500,1,3600,33.33,Medium,0.06,2000,120000
Munchies,Satyam Khobra,11300,10,5,10100,200,FALSE,200,1200,1,40000,50.5,High,0.2,10100,2020000
Munchies,Betty Crocker Complete Pancake Mix Original,11000,4,6,10500,250,FALSE,500,500,1,125000,42,High,0.25,10500,5250000
Munchies,Borges Durum Wheat Fusilli Pasta ,25000,0,3,25000,500,FALSE,500,0,1,250000,50,High,0.5,25000,12500000
Munchies,24 Mantra Organic Green Moong Dal - Split,13500,0,2,13500,500,FALSE,500,0,1,250000,27,High,0.5,13500,6750000
Munchies,Weikfield Vanilla Flavoured Custard Powder,3700,0,6,3700,100,FALSE,100,0,1,10000,37,Medium,0.1,3700,370000
Munchies,Tata Sampann Moong Dal Split,18000,1,5,17800,1000,FALSE,200,200,0.9,200000,17.8,High,1,17800,3560000
Munchies,Tata Sampann Kala Chana,6400,0,5,6400,500,FALSE,500,0,0.9,250000,12.8,High,0.5,6400,3200000
Munchies,Saffola Soya Chunks Mealmaker,5000,0,2,5000,200,FALSE,200,0,1,40000,25,High,0.2,5000,1000000
Munchies,24 Mantra Bura Sugar (Demerara),8000,10,6,7200,500,FALSE,500,800,0.9,250000,14.4,High,0.5,7200,3600000
Munchies,Popular Essentials Green Cardamom (Elaichi),20000,1,6,19800,50,FALSE,50,200,1,2500,396,High,0.05,19800,990000
Munchies,Hershey's Syrup Delicious Strawberry,9500,0,1,9500,200,FALSE,200,0,1,40000,47.5,High,0.2,9500,1900000
Munchies,Popular Essentials Anjeer,19000,11,4,16900,100,FALSE,100,2100,1,10000,169,High,0.1,16900,1690000
Munchies,Popular Essentials Mustard Seeds Rai Small,2000,0,2,2000,100,FALSE,100,0,1,10000,20,Medium,0.1,2000,200000
Munchies,Weikfield Baking Powder,3300,3,6,3200,100,FALSE,100,100,1,10000,32,Medium,0.1,3200,320000
Munchies,Dabur Honey Squeezy,18500,9,6,16700,225,FALSE,225,1800,1,50625,74.22,High,0.225,16700,3757500
Munchies,Tata Sampann High Protein Kali Urad,9100,14,6,7800,500,FALSE,500,1300,0.9,250000,15.6,High,0.5,7800,3900000
Munchies,Everest Kitchen King Masala,3700,2,6,3600,50,FALSE,50,100,1,2500,72,Medium,0.05,3600,180000
Munchies,Chef's Basket Durum Wheat Fusilli Pasta,16000,50,6,8000,500,FALSE,500,8000,1,250000,16,High,0.5,8000,4000000
Munchies,TilSona Til Oil,18000,10,2,16200,500,FALSE,500,1800,1,250000,32.4,High,0.5,16200,8100000
Munchies,Top Ramen Chicken Noodles,6000,10,1,5400,280,FALSE,280,600,1,78400,19.29,High,0.28,5400,1512000
Munchies,Everest Chaat Masala,3500,2,1,3400,50,FALSE,50,100,1,2500,68,Medium,0.05,3400,170000
Munchies,Keya Wonder Red Hot Chilli Flakes,8900,10,2,8000,40,FALSE,40,900,1,1600,200,High,0.04,8000,320000
Munchies,Popular Essentials White Peas (Un-Polished),8000,10,5,7200,500,FALSE,500,800,0.9,250000,14.4,High,0.5,7200,3600000
Munchies,Chings Secret Chowmein Hakka Noodles Masala ,4400,0,2,4400,60,FALSE,60,0,1,3600,73.33,High,0.06,4400,264000
Munchies,Dhara Filtered Groundnut Oil (Jar),105000,1,6,103500,5000,FALSE,5,1500,1,25000,20.7,High,5,103500,517500
Munchies,Pillsbury Choco Chip Pancake Mix,9900,5,6,9400,165,FALSE,165,500,1,27225,56.97,High,0.165,9400,1551000
Munchies,Hershey's Caramel Syrup,23000,0,1,23000,623,FALSE,623,0,1,388129,36.92,High,0.623,23000,14329000
Munchies,Pillsbury Multi Grain Atta,6000,6,3,5600,1000,FALSE,1,400,0.8,1000,5.6,High,1,5600,5600
Munchies,McCain New Mini Samosa with Cheese Corn Style Filling,12000,1,2,11800,240,FALSE,240,200,1,57600,49.17,High,0.24,11800,2832000
Munchies,Satyam Puffed Rice Kurmura (A),4300,0,6,4300,200,FALSE,200,0,1,40000,21.5,High,0.2,4300,860000
Munchies,MTR 3 Min Poha,2500,0,6,2500,60,FALSE,60,0,1,3600,41.67,Medium,0.06,2500,150000
Munchies,Ching's Manchurian Instant Noodles,1500,0,5,1500,60,FALSE,60,0,1,3600,25,Low,0.06,1500,90000
Munchies,Everest Pav Bhaji Masala,7000,0,2,7000,100,FALSE,100,0,1,10000,70,High,0.1,7000,700000
Munchies,Hershey's Chocolate Flavour Syrup,22000,6,6,20500,623,FALSE,680,1500,1,423640,32.91,High,0.623,20500,13940000
Munchies,Popular Essentials Dhania (Coriander Seeds),5500,16,4,4600,200,FALSE,200,900,1,40000,23,High,0.2,4600,920000
Munchies,24 Mantra Red Chilly Whole,7000,7,1,6500,100,FALSE,100,500,1,10000,65,High,0.1,6500,650000
Munchies,Dabur Honey - World's No.1,12000,0,6,12000,250,FALSE,250,0,1,62500,48,High,0.25,12000,3000000
Munchies,24 Mantra Organic Puffed Rice,4000,2,6,3900,200,FALSE,200,100,1,40000,19.5,High,0.2,3900,780000
Munchies,24 Mantra Organic Wheat Daliya ,4800,2,2,4700,500,FALSE,500,100,0.9,250000,9.4,High,0.5,4700,2350000
Munchies,24 Mantra Organic Ragi Flour,6500,20,4,5200,500,FALSE,500,1300,0.9,250000,10.4,High,0.5,5200,2600000
Munchies,Popular Essentials Cinnamon Whole (Dalchini),3500,5,6,3300,25,FALSE,25,200,1,625,132,Medium,0.025,3300,82500
Munchies,Sundrop Super Lite Advanced - Sunflower Oil,21500,0,4,21500,1000,FALSE,1,0,1,1000,21.5,High,1,21500,21500
Munchies,Pillsbury Atta/Godihittu - Chakki Fresh,10200,7,4,9400,2000,FALSE,2,800,0.8,4000,4.7,High,2,9400,18800
Munchies,Popular Essentials Green Moong Chilka/Chilka (Un-Polished),8500,7,5,7900,500,FALSE,500,600,0.9,250000,15.8,High,0.5,7900,3950000
Munchies,Popular Essentials HMT Kolam Steam,7500,0,3,7500,1000,FALSE,1,0,0.9,1000,7.5,High,1,7500,7500
Munchies,Popular Essentials Black Urad Split,8000,10,4,7200,500,FALSE,500,800,0.9,250000,14.4,High,0.5,7200,3600000
Munchies,Keya Oregano,10900,10,5,9800,9,FALSE,9,1100,1,81,1088.89,High,0.009,9800,88200
Munchies,Popular Essentials Pink Rajma,10000,10,6,9000,500,FALSE,500,1000,1,250000,18,High,0.5,9000,4500000
Munchies,Everest Chicken Masala,7400,2,6,7200,100,FALSE,100,200,1,10000,72,High,0.1,7200,720000
Munchies,Popular Essentials HMT Kolam Steam,37000,10,6,33300,5000,FALSE,5,3700,0.9,25000,6.66,High,5,33300,166500
Munchies,Everest Shahi Paneer Masala,4200,4,5,4000,50,FALSE,50,200,1,2500,80,High,0.05,4000,200000
Munchies,Godrej Yummiez Chicken Nuggets,32500,9,1,29300,500,FALSE,500,3200,1,250000,58.6,High,0.5,29300,14650000
Munchies,Flying Bird Vanilla Essence,3500,2,6,3400,20,FALSE,20,100,1,400,170,Medium,0.02,3400,68000
Munchies,Everest Sabji Masala,3000,3,6,2900,50,FALSE,50,100,1,2500,58,Medium,0.05,2900,145000
Munchies,Popular Essentials Californian Almond,69500,32,6,47000,500,FALSE,500,22500,1,250000,94,High,0.5,47000,23500000
Munchies,Cornitos Cornitos Taco Shells - 4 Inches,11000,20,6,8800,80,FALSE,80,2200,1,6400,110,High,0.08,8800,704000
Munchies,Everest Rajma Masala,3300,3,5,3200,50,FALSE,50,100,1,2500,64,Medium,0.05,3200,160000
Munchies,Popular Essentials White Til,4000,5,1,3800,100,FALSE,100,200,1,10000,38,High,0.1,3800,380000
Munchies,Amul Dark Compound Chocolate Slab,12500,2,6,12200,500,FALSE,500,300,1,250000,24.4,High,0.5,12200,6100000
Munchies,Mothers Recipe Papad Chana Masala,7900,10,6,7100,200,FALSE,200,800,1,40000,35.5,High,0.2,7100,1420000
Munchies,Ching's Schezwan Masala Instant Noodles,6000,0,1,6000,240,FALSE,240,0,1,57600,25,High,0.24,6000,1440000
Munchies,Amul Milk Compound Chocolate Slab,11000,2,6,10700,500,FALSE,500,300,1,250000,21.4,High,0.5,10700,5350000
Munchies,Eastern Chicken Masala,7000,7,3,6500,100,FALSE,100,500,1,10000,65,High,0.1,6500,650000
Munchies,Popular Essentials Methi Seeds,2500,0,5,2500,100,FALSE,100,0,1,10000,25,Medium,0.1,2500,250000
Munchies,Saffola Yummy Masala Noodles ,2000,0,2,2000,46,FALSE,46,0,1,2116,43.48,Medium,0.046,2000,92000
Munchies,Cadbury Hot Chocolate,17500,5,6,16600,200,FALSE,200,900,1,40000,83,High,0.2,16600,3320000
Munchies,Ching's Chicken Chilli Masala,1000,0,6,1000,20,FALSE,20,0,1,400,50,Low,0.02,1000,20000
Munchies,Dabur Keora water - Authentic flavour for Biryani's and Desserts,6200,6,6,5800,250,FALSE,250,400,1,62500,23.2,High,0.25,5800,1450000
Munchies,Popular Essentials Black Cardamom/Elaichi ,10000,10,6,9000,50,FALSE,50,1000,1,2500,180,High,0.05,9000,450000
Munchies,Popular Essentials Idli Rice,6000,10,4,5400,1000,FALSE,1,600,0.8,1000,5.4,High,1,5400,5400
Munchies,Everest Chole Masala,3300,3,1,3200,50,FALSE,50,100,1,2500,64,Medium,0.05,3200,160000
Munchies,Dabur Hommade Tamarind Paste,4800,6,6,4500,200,FALSE,200,300,1,40000,22.5,High,0.2,4500,900000
Munchies,"""Maggi Magic Cubes, Vegetarian Masala (Free 2 Cubes Inside)""",3500,2,6,3400,48,FALSE,48,100,1,2304,70.83,Medium,0.048,3400,163200
Munchies,Popular Essentials Cooking Soda,3000,10,6,2700,200,FALSE,200,300,0.9,40000,13.5,Medium,0.2,2700,540000
Munchies,RRO Primio Refined Groundnut Oil Pet Bottle,25500,6,2,23900,1000,FALSE,1,1600,1,1000,23.9,High,1,23900,23900
Munchies,Everest Pani Puri Masala,3100,3,6,3000,50,FALSE,50,100,1,2500,60,Medium,0.05,3000,150000
Munchies,Nissin Cup Noodles Tangy Tomato,5000,10,2,4500,70,FALSE,70,500,1,4900,64.29,High,0.07,4500,315000
Munchies,Ching's Veg Manchurian Masala,1000,0,2,1000,20,FALSE,20,0,1,400,50,Low,0.02,1000,20000
Munchies,Ceres Foods Fish Mustard Instant Liquid Masala,22000,50,6,11000,200,FALSE,200,11000,1,40000,55,High,0.2,11000,2200000
Munchies,Everest Garam Masala,15800,10,6,14200,200,FALSE,200,1600,1,40000,71,High,0.2,14200,2840000
Munchies,24 Mantra Organic Jowar Flour,7000,7,6,6500,500,FALSE,500,500,0.9,250000,13,High,0.5,6500,3250000
Munchies,Maggi Coconut Milkpowder,10000,0,6,10000,100,FALSE,100,0,1,10000,100,High,0.1,10000,1000000
Munchies,On1y Pepper Grinder,15900,9,1,14400,50,FALSE,50,1500,1,2500,288,High,0.05,14400,720000
Munchies,Popular Essentials Rice Flour,6000,0,3,6000,1000,FALSE,1,0,0.8,1000,6,High,1,6000,6000
Munchies,Sunfeast Yippee! Pasta Treat - Sour Cream Onion,2800,10,1,2500,65,FALSE,65,300,1,4225,38.46,Medium,0.065,2500,162500
Munchies,24 Mantra Organic Brown Sona Masoori Rice,9500,0,6,9500,1000,FALSE,1,0,0.9,1000,9.5,High,1,9500,9500
Munchies,Happilo Premium Afghani Anjeer,36500,29,2,25600,200,FALSE,200,10900,1,40000,128,High,0.2,25600,5120000
Munchies,Popular Essentials Chiroti Sooji,3500,2,6,3400,500,FALSE,500,100,0.9,250000,6.8,Medium,0.5,3400,1700000
Munchies,RRO Til Dil Premium Til Oil Bottle,33000,10,5,29400,1000,FALSE,1,3600,1,1000,29.4,High,1,29400,29400
Munchies,Popular Essentials Red Rajma,9000,10,6,8100,500,FALSE,500,900,0.9,250000,16.2,High,0.5,8100,4050000
Munchies,Cornitos Peanut - Premium Salted ,12000,10,6,10800,150,FALSE,150,1200,1,22500,72,High,0.15,10800,1620000
Munchies,Popular Essentials Black Pepper,10000,10,5,9000,100,FALSE,100,1000,1,10000,90,High,0.1,9000,900000
Munchies,24 Mantra Organic Tur Dal - Split,13000,7,6,12000,500,FALSE,500,1000,1,250000,24,High,0.5,12000,6000000
Munchies,Sugarfree Gold Low Calorie Sweetner,6500,6,3,6100,110,FALSE,100,400,1,11000,55.45,High,0.11,6100,610000
Munchies,Ching's Secret Paneer Chilli Masala,1000,0,2,1000,20,FALSE,20,0,1,400,50,Low,0.02,1000,20000
Munchies,Dabur Honey ,22000,7,3,20400,500,FALSE,500,1600,1,250000,40.8,High,0.5,20400,10200000
Munchies,Sunfeast Yippee! Pasta Treat - Sour Cream Onion,2800,17,3,2300,65,FALSE,65,500,1,4225,35.38,Medium,0.065,2300,149500
Munchies,Everest Tea Masala,5500,9,2,5000,50,FALSE,50,500,1,2500,100,High,0.05,5000,250000
Munchies,Ching's Paneer Chilli Masala,4400,0,4,4400,60,FALSE,60,0,1,3600,73.33,High,0.06,4400,264000
Munchies,Sunfeast YiPPee! Magic Masala Noodles,7000,10,3,6300,405,FALSE,405,700,0.9,164025,15.56,High,0.405,6300,2551500
Munchies,Everest Meat Masala Powder,7400,9,3,6700,100,FALSE,100,700,1,10000,67,High,0.1,6700,670000
Munchies,Pillsbury Atta With Multigrains Wheat Grains,29500,16,6,24500,5000,FALSE,5,5000,0.8,25000,4.9,High,5,24500,122500
Munchies,Mother's Recipe Tamarind Paste,5000,2,6,4900,200,FALSE,200,100,1,40000,24.5,High,0.2,4900,980000
Munchies,Quaker Oats Breakfast Cereals - With Flavour Mix Nutritious Rich Source Of Energy,4900,8,6,4500,200,FALSE,200,400,1,40000,22.5,High,0.2,4500,900000
Munchies,Popular Essentials Cloves (Lavang),7500,17,6,6200,50,FALSE,50,1300,1,2500,124,High,0.05,6200,310000
Munchies,Sunfeast Yippee! Power Up Atta Noodles,9600,15,6,8100,280,FALSE,280,1500,1,78400,28.93,High,0.28,8100,2268000
Munchies,Suhana Paneer Tikka Masala Mix,4000,5,6,3800,50,FALSE,50,200,1,2500,76,High,0.05,3800,190000
Munchies,24 Mantra Turmeric Powder,3500,2,6,3400,100,FALSE,100,100,1,10000,34,Medium,0.1,3400,340000
Munchies,24 Mantra Super Grain Quinoa,19000,0,4,19000,500,FALSE,500,0,1,250000,38,High,0.5,19000,9500000
Munchies,Everest Powder - Egg Curry Masala,4000,2,6,3900,50,FALSE,50,100,1,2500,78,High,0.05,3900,195000
Munchies,Popular Essentials Pe Shah Jeera ,6000,15,6,5100,50,FALSE,50,900,1,2500,102,High,0.05,5100,255000
Munchies,24 Mantra Organic Sattu Atta,9500,0,6,9500,500,FALSE,500,0,0.9,250000,19,High,0.5,9500,4750000
Munchies,Smith & Jones Pasta Masala,4600,0,6,4600,54,FALSE,54,0,1,2916,85.19,High,0.054,4600,248400
Munchies,Weikfield Vanilla Custard Powder,14200,9,3,12800,500,FALSE,500,1400,1,250000,25.6,High,0.5,12800,6400000
Munchies,Sugarfree Natura Low Calorie Sweetner ,30000,10,3,27000,42,FALSE,42,3000,1,1764,642.86,High,0.042,27000,1134000
Munchies,Pillsbury Vanilla Custard Powder,3700,2,6,3600,100,FALSE,100,100,1,10000,36,Medium,0.1,3600,360000
Munchies,24 Mantra Organic Rajma,14500,0,6,14500,500,FALSE,500,0,1,250000,29,High,0.5,14500,7250000
Munchies,Popular Essentials Broken Wheat/Daliya,3500,2,6,3400,500,FALSE,500,100,0.9,250000,6.8,Medium,0.5,3400,1700000
Munchies,Zorabian Chicken Smoked Ham,20500,5,1,19400,250,FALSE,250,1100,1,62500,77.6,High,0.25,19400,4850000
Munchies,Smith & Jones Peri Peri Masala,9900,0,6,9900,75,FALSE,75,0,1,5625,132,High,0.075,9900,742500
Munchies,Saffola Veggie Twist Masala Oats,19500,12,2,17100,500,FALSE,500,2400,1,250000,34.2,High,0.5,17100,8550000
Munchies,Popular Essentials Urad Dal Split (Un-Polished),8500,9,5,7700,500,FALSE,500,800,0.9,250000,15.4,High,0.5,7700,3850000
Munchies,Weikfield Baking Powder,2200,0,6,2200,50,FALSE,50,0,1,2500,44,Medium,0.05,2200,110000
Munchies,Popular Essentials Bajra Whole,6500,13,6,5600,1000,FALSE,1,900,0.8,1000,5.6,High,1,5600,5600
Munchies,Weikfield Veg Jelly Crystals - Strawberry,4500,2,6,4400,90,FALSE,90,100,1,8100,48.89,High,0.09,4400,396000
Munchies,Weikfield Veg Jelly Crystals - Raspberry,4500,2,6,4400,90,FALSE,90,100,1,8100,48.89,High,0.09,4400,396000
Munchies,Popular Essentials Masoor Dal Split (Un-Polished),7000,10,4,6300,500,FALSE,500,700,0.9,250000,12.6,High,0.5,6300,3150000
Munchies,Popular Essentials Ajwain Whole,5000,12,2,4400,100,FALSE,100,600,1,10000,44,High,0.1,4400,440000
Munchies,Popular Essentials Pista Salted (With Shell),47000,21,5,37100,250,FALSE,250,9900,1,62500,148.4,High,0.25,37100,9275000
Munchies,The Bake Shop Bread Crumbs,5000,6,3,4700,400,FALSE,400,300,0.9,160000,11.75,High,0.4,4700,1880000
Munchies,Popular Essentials Horse Gram,4000,10,4,3600,500,FALSE,500,400,0.9,250000,7.2,High,0.5,3600,1800000
Munchies,Hershey's Chocolate Syrup,9500,0,4,9500,200,FALSE,200,0,1,40000,47.5,High,0.2,9500,1900000
Munchies,Godrej Yummiez Chilli Chicken Sausages ,16000,10,3,14400,250,FALSE,250,1600,1,62500,57.6,High,0.25,14400,3600000
Munchies,Everest Kasuri Methi,2500,0,6,2500,25,FALSE,25,0,1,625,100,Medium,0.025,2500,62500
Munchies,Satyam Makhana,20800,0,6,20800,100,FALSE,100,0,1,10000,208,High,0.1,20800,2080000
Munchies,Everest Tandoori Chicken Masala,3900,2,5,3800,50,FALSE,50,100,1,2500,76,Medium,0.05,3800,190000
Munchies,Weikfield Falooda Mix - Kesar Pista,4900,2,3,4800,200,FALSE,200,100,1,40000,24,High,0.2,4800,960000
Munchies,Weikfield Cocoa Powder,7000,7,6,6500,50,FALSE,50,500,1,2500,130,High,0.05,6500,325000
Munchies,Pantai Coconut Cream,15000,4,4,14300,400,FALSE,400,700,1,160000,35.75,High,0.4,14300,5720000
Munchies,Popular Essentials Coriander Seeds,1500,0,5,1500,50,FALSE,50,0,1,2500,30,Low,0.05,1500,75000
Munchies,Ching's Singapore Curry Instant Noodles,6000,0,4,6000,240,FALSE,240,0,1,57600,25,High,0.24,6000,1440000
Munchies,Eastern Fish Masala,4800,2,5,4700,100,FALSE,100,100,1,10000,47,High,0.1,4700,470000
Munchies,Pillsbury Atta/Godihittu - Chakki Fresh,27500,0,6,27500,5000,FALSE,5,0,0.8,25000,5.5,High,5,27500,137500
Munchies,"Oleev Smart Oil Fortified with VIT A, D, E & K (Pouch)",21500,9,4,19400,1000,FALSE,1,2100,1,1000,19.4,High,1,19400,19400
Munchies,Everest Dry Ginger Powder,7500,9,4,6800,100,FALSE,100,700,1,10000,68,High,0.1,6800,680000
Munchies,Pillsbury Cooker Cake Mix - Choco,10000,11,6,8900,159,FALSE,159,1100,1,25281,55.97,High,0.159,8900,1415100
Munchies,Hersheys Chocolate Almond Syrup,20000,0,2,20000,450,FALSE,450,0,1,202500,44.44,High,0.45,20000,9000000
Munchies,Satyam Nighties Spices  Chilli Pandi,5600,7,5,5200,100,FALSE,100,400,1,10000,52,High,0.1,5200,520000
Munchies,Popular Essentials Popular Essential Pista Salted (With Shell),19000,10,6,17100,100,FALSE,100,1900,1,10000,171,High,0.1,17100,1710000
Munchies,Godrej Yummiez Chicken Punjabi Tikka ,29500,9,6,26600,360,FALSE,360,2900,1,129600,73.89,High,0.36,26600,9576000
Munchies,Popular Essentials Rozana Sona Masuri Raw Rice,35000,10,5,31200,5000,FALSE,5,3800,0.9,25000,6.24,High,5,31200,156000
Munchies,24 Mantra Mustard Oil (Cold Pressed) ,35000,10,6,31200,1000,FALSE,1,3800,1,1000,31.2,High,1,31200,31200
Munchies,24 Mantra Organic Black Pepper,17000,7,6,15700,100,FALSE,100,1300,1,10000,157,High,0.1,15700,1570000
Munchies,Popular Essentials Green Moong Whole,9000,16,3,7500,500,FALSE,500,1500,0.9,250000,15,High,0.5,7500,3750000
Munchies,24 Mantra Organic Masoor Dal - Split,9500,7,6,8800,500,FALSE,500,700,0.9,250000,17.6,High,0.5,8800,4400000
Munchies,Praakritik Organic Natural Rock Salt,6000,6,3,5600,500,FALSE,500,400,0.9,250000,11.2,High,0.5,5600,2800000
Munchies,24 Mantra Sunflower Oil (Cold Pressed) Pet Bottle,39000,11,5,34700,1000,FALSE,1,4300,1,1000,34.7,High,1,34700,34700
Munchies,"Ching's Secret Instant Noodles, Hot Garlic",6000,0,4,6000,240,FALSE,240,0,1,57600,25,High,0.24,6000,1440000
Munchies,Saffola Everyday Peppy Tomato Masala Oats,19500,12,6,17100,500,FALSE,500,2400,1,250000,34.2,High,0.5,17100,8550000
Munchies,Dabur 100% Pure Honey - Worlds No.1,43000,10,6,38700,1000,FALSE,1,4300,1,1000,38.7,High,1,38700,38700
Munchies,Popular Essentials Star Anise,7000,10,5,6300,25,FALSE,25,700,1,625,252,High,0.025,6300,157500
Munchies,Ching's Secret Chicken 65 Masala - Chicken,1000,0,5,1000,20,FALSE,20,0,1,400,50,Low,0.02,1000,20000
Munchies,Cadbury Cocoa Powder,22300,5,6,21100,150,FALSE,150,1200,1,22500,140.67,High,0.15,21100,3165000
Munchies,Praakritik Natural Desi Gir Cow A2 Ghee,145000,10,6,130500,540,FALSE,540,14500,1,291600,241.67,High,0.54,130500,70470000
Munchies,Praakritik Organic Poha,12000,6,5,11200,500,FALSE,500,800,1,250000,22.4,High,0.5,11200,5600000
Munchies,Praakritik Organic Natural Wild Forest Honey,16000,6,4,15000,200,FALSE,200,1000,1,40000,75,High,0.2,15000,3000000
Munchies,Popular Essentials Dry Dates (Kharak),14000,15,6,11800,250,FALSE,250,2200,1,62500,47.2,High,0.25,11800,2950000
Munchies,Popular Essentials Kashmiri Red Rajma,9500,6,4,8900,500,FALSE,500,600,0.9,250000,17.8,High,0.5,8900,4450000
Munchies,Dabur Hommade - Garlic Paste,5000,6,6,4700,200,FALSE,200,300,1,40000,23.5,High,0.2,4700,940000
Munchies,Dabur 100% Pure Honey,33000,10,1,29700,400,FALSE,400,3300,1,160000,74.25,High,0.4,29700,11880000
Munchies,Ching's Schezwan Fried Rice(Miracle Masala),4400,0,5,4400,60,FALSE,60,0,1,3600,73.33,High,0.06,4400,264000
Munchies,"""Maggi Magic Cubes, Vegetarian Masala""",3500,2,1,3400,40,FALSE,40,100,1,1600,85,Medium,0.04,3400,136000
Munchies,Everest Tandoori Chicken Masala,7400,9,3,6700,100,FALSE,100,700,1,10000,67,High,0.1,6700,670000
Munchies,Popular Essentials Red Poha,4500,4,6,4300,500,FALSE,500,200,0.9,250000,8.6,High,0.5,4300,2150000
Munchies,Everest Kitchen King Masala,14200,9,6,12800,200,FALSE,200,1400,1,40000,64,High,0.2,12800,2560000
Munchies,Pillsbury Oven Cake Mix - Rich Chocolate,16500,10,5,14700,285,FALSE,285,1800,1,81225,51.58,High,0.285,14700,4189500
Munchies,Eastern Super Garam Masala,7400,6,2,6900,200,FALSE,200,500,1,40000,34.5,High,0.2,6900,1380000
Munchies,Maggi Magic Cubes Extra Chicken,4000,2,6,3900,48,FALSE,48,100,1,2304,81.25,High,0.048,3900,187200
Munchies,Satyam Nighties Spices  Chilli Kashmiri,10200,6,6,9500,100,FALSE,100,700,1,10000,95,High,0.1,9500,950000
Munchies,Eastern Cumin Powder,4900,2,6,4800,100,FALSE,100,100,1,10000,48,High,0.1,4800,480000
Munchies,Popular Essentials Urad Gola White(Un-Polished),9000,10,6,8100,500,FALSE,500,900,0.9,250000,16.2,High,0.5,8100,4050000
Munchies,24 Mantra Organic Chana Dal,9500,6,5,8900,500,FALSE,500,600,0.9,250000,17.8,High,0.5,8900,4450000
Munchies,Delight Nuts Cashew Roasted & Salted,42500,20,6,34000,200,FALSE,200,8500,1,40000,170,High,0.2,34000,6800000
Munchies,Popular Essentials Mace/Javitri,9000,10,3,8100,20,FALSE,20,900,1,400,405,High,0.02,8100,162000
Munchies,Dlicia Whip Topping Bottle,23500,27,5,17100,1000,FALSE,1,6400,1,1000,17.1,High,1,17100,17100
Munchies,Mother's Recipe Paste Ginger & Garlic,7600,10,4,6800,300,FALSE,300,800,1,90000,22.67,High,0.3,6800,2040000
Munchies,24 Mantra Groundnut Oil (Cold Pressed) Pet Bottle,41000,10,6,36900,1000,FALSE,1,4100,1,1000,36.9,High,1,36900,36900
Munchies,Satyam Pulses Masur Dal,8700,6,6,8100,500,FALSE,500,600,0.9,250000,16.2,High,0.5,8100,4050000
Munchies,Delight Nuts Pista Roasted & Salted,42500,20,6,34000,200,FALSE,200,8500,1,40000,170,High,0.2,34000,6800000
Munchies,"Top Ramen Noodles, Atta",8000,0,1,8000,280,FALSE,280,0,1,78400,28.57,High,0.28,8000,2240000
Munchies,Hershey's Cocoa Powder,9500,0,5,9500,70,FALSE,70,0,1,4900,135.71,High,0.07,9500,665000
Munchies,Praakritik Organic Singhara Atta,24000,6,4,22500,500,FALSE,500,1500,1,250000,45,High,0.5,22500,11250000
Munchies,Gits Veg Biryani Ready to Eat,11000,10,6,9900,265,FALSE,265,1100,1,70225,37.36,High,0.265,9900,2623500
Munchies,Delight Nuts Cranberries Sliced ,29900,20,6,23900,200,FALSE,200,6000,1,40000,119.5,High,0.2,23900,4780000
Munchies,Borges Durum Wheat Pasta Superior Quality,25000,40,6,14900,500,FALSE,500,10100,1,250000,29.8,High,0.5,14900,7450000
Munchies,Ceres Foods Laal Maas Instant Liquid Masala,22000,50,5,11000,200,FALSE,200,11000,1,40000,55,High,0.2,11000,2200000
Munchies,Popular Essentials Sattu Atta,9000,12,3,7900,500,FALSE,500,1100,0.9,250000,15.8,High,0.5,7900,3950000
Munchies,Popular Essentials Mustard Seeds Rai Yellow,2500,0,5,2500,100,FALSE,100,0,1,10000,25,Medium,0.1,2500,250000
Munchies,Praakritik Organic Extra Virgin Coconut Oil,15000,10,5,13400,100,FALSE,100,1600,1,10000,134,High,0.1,13400,1340000
Munchies,Praakritik Organic Garlic Powder,11000,1,5,10800,100,FALSE,100,200,1,10000,108,High,0.1,10800,1080000
Munchies,Sugarfree Gold Low Calorie Sweetner ,12500,5,6,11800,100,FALSE,100,700,1,10000,118,High,0.1,11800,1180000
Munchies,Aashirvaad Breakfast Instant Mix - Rice Idli,7500,30,6,5200,200,FALSE,200,2300,1,40000,26,High,0.2,5200,1040000
Munchies,Kitchens Of India Mutter Paneer,13000,4,6,12400,285,FALSE,285,600,1,81225,43.51,High,0.285,12400,3534000
Munchies,Ching's Secret Veg Manchurian Masala,4400,0,6,4400,60,FALSE,60,0,1,3600,73.33,High,0.06,4400,264000
Munchies,Popular Essentials Jowa Flour,5000,2,5,4900,500,FALSE,500,100,0.9,250000,9.8,High,0.5,4900,2450000
Munchies,Everest Shahi Biryani Masala,24500,0,6,24500,200,FALSE,200,0,1,40000,122.5,High,0.2,24500,4900000
Munchies,Popular Essentials Black Til,5000,6,4,4700,100,FALSE,100,300,1,10000,47,High,0.1,4700,470000
Munchies,Popular Essentials Pancharatna Dal,8000,10,6,7200,500,FALSE,500,800,0.9,250000,14.4,High,0.5,7200,3600000
Munchies,Saffola 100% Pure Honey,47500,8,2,43700,1000,FALSE,750,3800,1,750000,43.7,High,1,43700,32775000
Munchies,Popular Essentials Tamarind,15000,14,6,12800,500,FALSE,500,2200,1,250000,25.6,High,0.5,12800,6400000
Munchies,Gits Rice Dosa Instant Breakfast Mix,6000,5,5,5700,200,FALSE,200,300,1,40000,28.5,High,0.2,5700,1140000
Munchies,Popular Essentials Poppy Seeds (Gasagase),28000,7,6,26000,100,FALSE,100,2000,1,10000,260,High,0.1,26000,2600000
Munchies,Hershey's Hot Chocolate Powder,21000,0,4,21000,250,FALSE,250,0,1,62500,84,High,0.25,21000,5250000
Munchies,Borges Farfalle Durum Wheat Pasta ,25000,0,5,25000,500,FALSE,500,0,1,250000,50,High,0.5,25000,12500000
Munchies,Satyam Chilli  Bedgi,8200,10,5,7300,100,FALSE,100,900,1,10000,73,High,0.1,7300,730000
Munchies,Aashirvaad Instant Mix - Rice Dosa,7500,30,6,5200,200,FALSE,200,2300,1,40000,26,High,0.2,5200,1040000
Munchies,Hershey's Cocoa - Natural Unsweetened,27000,10,4,24300,225,FALSE,225,2700,1,50625,108,High,0.225,24300,5467500
Munchies,Weikfield Veg Jelly Crystals - Mango,4500,2,6,4400,90,FALSE,90,100,1,8100,48.89,High,0.09,4400,396000
Munchies,Praakritik Orrganic Cold Pressed Sesame Oil,13000,10,5,11700,100,FALSE,100,1300,1,10000,117,High,0.1,11700,1170000
Munchies,Amulya Dairy Whitener ,38000,2,4,37200,1000,FALSE,1,800,1,1000,37.2,High,1,37200,37200
Munchies,ITC Master Chef Hyderabadi Biryani,7500,30,5,5200,80,FALSE,80,2300,1,6400,65,High,0.08,5200,416000
Munchies,Flying Bird Butter Scotch Essence,5000,2,6,4900,20,FALSE,20,100,1,400,245,High,0.02,4900,98000
Munchies,Dabur Hommade - Ginger Paste,5000,6,6,4700,200,FALSE,200,300,1,40000,23.5,High,0.2,4700,940000
Munchies,Popular Essentials Green Peas (Un-Polished),12000,10,5,10800,500,FALSE,500,1200,1,250000,21.6,High,0.5,10800,5400000
Munchies,Quaker Oats Pouch,27600,10,6,24800,1500,FALSE,1,2800,0.9,1500,16.53,High,1.5,24800,24800
Munchies,24 Mantra Organic Urad White Whole,14500,15,4,12200,500,FALSE,500,2300,1,250000,24.4,High,0.5,12200,6100000
Munchies,Popular Essentials Guntur Chilli Stemless,4000,2,2,3900,100,FALSE,100,100,1,10000,39,High,0.1,3900,390000
Munchies,Popular Essentials Moth Whole,9000,10,6,8100,500,FALSE,500,900,0.9,250000,16.2,High,0.5,8100,4050000
Munchies,Keya Pizza Seasoning,10900,17,6,9000,45,FALSE,45,1900,1,2025,200,High,0.045,9000,405000
Munchies,Keya Piri Piri | Exotic Spices Mix,10900,20,6,8700,80,FALSE,80,2200,1,6400,108.75,High,0.08,8700,696000
Munchies,24 Mantra Organic Moong Dal,13500,7,6,12500,500,FALSE,500,1000,1,250000,25,High,0.5,12500,6250000
Munchies,Betty Crocker French Vanilla Cake Mix,31000,10,6,27600,520,FALSE,520,3400,1,270400,53.08,High,0.52,27600,14352000
Munchies,Delight Nuts Dried Cranberries ,34000,20,6,27200,200,FALSE,200,6800,1,40000,136,High,0.2,27200,5440000
Munchies,Everest Kesari Milk Masala,20500,0,2,20500,50,FALSE,50,0,1,2500,410,High,0.05,20500,1025000
Munchies,Tong Garden Salted Cocktail Nuts,29500,9,5,26600,160,FALSE,160,2900,1,25600,166.25,High,0.16,26600,4256000
Munchies,MTR Uttapam Mix,16500,5,6,15600,500,FALSE,500,900,1,250000,31.2,High,0.5,15600,7800000
Munchies,Gits Khaman Dhokla Instant Snack Mix,6500,6,6,6100,180,FALSE,180,400,1,32400,33.89,High,0.18,6100,1098000
Munchies,Happilo Premium 100% Natural Whole Cashews,33500,29,6,23500,200,FALSE,200,10000,1,40000,117.5,High,0.2,23500,4700000
Munchies,Everest Dry Mango Powder,8000,0,5,8000,100,FALSE,100,0,1,10000,80,High,0.1,8000,800000
Munchies,Dabur Hommade - Ginger Garlic Past Tub,11000,5,6,10400,400,FALSE,400,600,1,160000,26,High,0.4,10400,4160000
Munchies,Everest Chicken Masala,14700,10,6,13200,200,FALSE,200,1500,1,40000,66,High,0.2,13200,2640000
Munchies,Gits Medu Vada Instant Snack Mix,9000,4,6,8600,200,FALSE,200,400,1,40000,43,High,0.2,8600,1720000
Munchies,Weikfield Drinking Chocolate Powder,6500,10,6,5800,100,FALSE,100,700,1,10000,58,High,0.1,5800,580000
Munchies,Popular Essentials Regular White Lobia,7000,10,6,6300,500,FALSE,500,700,0.9,250000,12.6,High,0.5,6300,3150000
Munchies,Puro Healthy Salt Crystal,13500,7,6,12500,1000,FALSE,1,1000,0.9,1000,12.5,High,1,12500,12500
Munchies,Popular Essentials Premium Jeera Rice,14000,0,5,14000,1000,FALSE,1,0,0.9,1000,14,High,1,14000,14000
Munchies,Smith & Jones Shahi Paneer Masala Mix,4400,0,6,4400,60,FALSE,60,0,1,3600,73.33,High,0.06,4400,264000
Munchies,Betty Crocker Mug Treats - Chocolate Mix - Pack of 4,20000,11,6,17800,264,FALSE,264,2200,1,69696,67.42,High,0.264,17800,4699200
Munchies,Smith & Jones Pasta Masala,6000,10,5,5400,108,FALSE,108,600,1,11664,50,High,0.108,5400,583200
Munchies,Catch Black Pepper Sprinkler,10000,0,1,10000,50,FALSE,50,0,1,2500,200,High,0.05,10000,500000
Munchies,Weikfield Cooker Cake Mix - Chocolate,9500,6,6,8900,150,FALSE,150,600,1,22500,59.33,High,0.15,8900,1335000
Munchies,ITC Master Chef Butter Chicken,7500,30,6,5200,80,FALSE,80,2300,1,6400,65,High,0.08,5200,416000
Munchies,Masala Oats Masala & Coriander ,19500,9,5,17600,500,FALSE,500,1900,1,250000,35.2,High,0.5,17600,8800000
Munchies,Smith & Jones Mutter Paneer Masala,4200,0,6,4200,60,FALSE,60,0,1,3600,70,High,0.06,4200,252000
Munchies,Kitchens of India Dal Bukhara Gravy Mix,11000,30,6,7700,285,FALSE,285,3300,1,81225,27.02,High,0.285,7700,2194500
Munchies,Popular Essentials Fried Gram (Bengal Gram),7000,10,6,6300,500,FALSE,500,700,0.9,250000,12.6,High,0.5,6300,3150000
Munchies,Gits Jalebi with Maker Dessert Mix,7500,16,6,6300,100,FALSE,100,1200,1,10000,63,High,0.1,6300,630000
Munchies,Popular Essentials Soya Beans ,8000,6,6,7500,500,FALSE,500,500,0.9,250000,15,High,0.5,7500,3750000
Munchies,24 Mantra Organic Roasted Bengal Gram Dal,10500,7,6,9700,500,FALSE,500,800,1,250000,19.4,High,0.5,9700,4850000
Munchies,Keya Italian Seasoning,10900,10,6,9800,35,FALSE,35,1100,1,1225,280,High,0.035,9800,343000
Munchies,MTR Idli/Dosa/Chilly Chutney Powder,11500,0,3,11500,200,FALSE,200,0,1,40000,57.5,High,0.2,11500,2300000
Munchies,Delight Nuts Trail Mix ,39900,25,6,29900,200,FALSE,200,10000,1,40000,149.5,High,0.2,29900,5980000
Munchies,Praakritik Organic Chilka Moong Dal,12000,10,6,10800,500,FALSE,500,1200,1,250000,21.6,High,0.5,10800,5400000
Munchies,Smith & Jones Garlic & Herbs Masala Mix,9900,0,6,9900,75,FALSE,75,0,1,5625,132,High,0.075,9900,742500
Munchies,Eastern Tamarind,6300,0,6,6300,200,FALSE,200,0,1,40000,31.5,High,0.2,6300,1260000
Munchies,Tong Garden Wasabi Coated Greenpeas Tin,20000,11,6,17800,180,FALSE,180,2200,1,32400,98.89,High,0.18,17800,3204000
Munchies,Flying Bird Pineapple Artifical Food Essence,5000,2,6,4900,20,FALSE,20,100,1,400,245,High,0.02,4900,98000
Munchies,Mother's Recipe Tamarind Paste,5000,2,2,4900,200,FALSE,200,100,1,40000,24.5,High,0.2,4900,980000
Munchies,Japanese Choice Udon Noodles,29500,9,6,26600,250,FALSE,250,2900,1,62500,106.4,High,0.25,26600,6650000
Munchies,Pantai Coconut Milk,15000,0,4,15000,400,FALSE,400,0,1,160000,37.5,High,0.4,15000,6000000
Munchies,Praakritik Organic Masoor Dal,13000,10,6,11600,500,FALSE,500,1400,1,250000,23.2,High,0.5,11600,5800000
Munchies,Popular Essentials Classic Sona Masuri Rice,43000,10,6,38700,5000,FALSE,5,4300,0.9,25000,7.74,High,5,38700,193500
Munchies,Popular Essentials Salted Murmure ,7000,18,6,5700,400,FALSE,400,1300,0.9,160000,14.25,High,0.4,5700,2280000
Munchies,Oleev Active Oil (Pouch),26500,9,6,23900,1000,FALSE,1,2600,1,1000,23.9,High,1,23900,23900
Munchies,Delight Nuts Dried Blueberries ,54000,20,6,43200,150,FALSE,150,10800,1,22500,288,High,0.15,43200,6480000
Munchies,Popular Essentials Double Beans White,6000,10,6,5400,250,FALSE,250,600,1,62500,21.6,High,0.25,5400,1350000
Munchies,Delight Nuts Almond Natural ,34900,20,6,27900,200,FALSE,200,7000,1,40000,139.5,High,0.2,27900,5580000
Munchies,Praakritik Organic Jaggery,16000,6,6,15000,900,FALSE,900,1000,0.9,810000,16.67,High,0.9,15000,13500000
Munchies,Praakritik Organic Raw Sugar,9000,6,6,8400,500,FALSE,500,600,0.9,250000,16.8,High,0.5,8400,4200000
Munchies,MTR Masala - Sambar Powder,11500,0,4,11500,200,FALSE,200,0,1,40000,57.5,High,0.2,11500,2300000
Munchies,RRO Til Dil Premium Til Oil Bottle,17300,6,6,16200,500,FALSE,500,1100,1,250000,32.4,High,0.5,16200,8100000
Munchies,ITC Master Chef Vegetable Biryani Cooking Paste,7500,30,5,5200,80,FALSE,80,2300,1,6400,65,High,0.08,5200,416000
Munchies,Jivana Jaggery,10000,0,2,10000,950,FALSE,950,0,0.9,902500,10.53,High,0.95,10000,9500000
Munchies,Praakritik Organic Besan,17000,6,6,15900,500,FALSE,500,1100,1,250000,31.8,High,0.5,15900,7950000
Munchies,MTR Instant Gulab Jamun Mix,19500,9,6,17600,500,FALSE,500,1900,1,250000,35.2,High,0.5,17600,8800000
Munchies,Maggi Magic Cubes Extra Chicken,19900,0,2,19900,240,FALSE,240,0,1,57600,82.92,High,0.24,19900,4776000
Munchies,On1y Mixed Herbs,9900,0,6,9900,14,FALSE,14,0,1,196,707.14,High,0.014,9900,138600
Munchies,Popular Essentials Urad Gola Black (Un-Polished),8000,10,6,7200,500,FALSE,500,800,0.9,250000,14.4,High,0.5,7200,3600000
Munchies,Gits Dessert Mix China Grass Bombay Halwa,5500,0,4,5500,80,FALSE,80,0,1,6400,68.75,High,0.08,5500,440000
Munchies,Praakritik Organic Basmati Rice,17000,0,5,17000,500,FALSE,500,0,1,250000,34,High,0.5,17000,8500000
Munchies,Ceres Foods Nalli Nihari Instant Liquid Masala,22000,50,6,11000,200,FALSE,200,11000,1,40000,55,High,0.2,11000,2200000
Munchies,Borges Canola Oil Pet Bottle,39900,0,6,39900,1000,FALSE,1,0,1,1000,39.9,High,1,39900,39900
Munchies,Suhana Biryani Masala,6600,0,6,6600,50,FALSE,50,0,1,2500,132,High,0.05,6600,330000
Munchies,On1y Black Salt Grinder,9900,0,6,9900,100,FALSE,100,0,1,10000,99,High,0.1,9900,990000
Munchies,Popular Essentials Nylon Til,4000,2,6,3900,100,FALSE,100,100,1,10000,39,High,0.1,3900,390000
Munchies,Pillsbury Rich Choco Oven Cake Mix - Egg Free,17000,6,6,15900,270,FALSE,270,1100,1,72900,58.89,High,0.27,15900,4293000
Munchies,Weikfield Tomato Salsa Instant Pasta,2500,0,1,2500,77,FALSE,77,0,1,5929,32.47,Medium,0.077,2500,192500
Munchies,Praakritik Organic Jowar Atta,11000,6,6,10300,500,FALSE,500,700,1,250000,20.6,High,0.5,10300,5150000
Munchies,Sugarfree Gold Low Calorie Sweetner ,27000,7,6,25100,50,FALSE,50,1900,1,2500,502,High,0.05,25100,1255000
Munchies,Epicurea Thai Jasmine Rice,29500,0,4,29500,500,FALSE,500,0,1,250000,59,High,0.5,29500,14750000
Munchies,Yummiez Chicken Garlic Fingers Pouch,25000,0,5,25000,400,FALSE,400,0,1,160000,62.5,High,0.4,25000,10000000
Munchies,RRO Primio Refined Groundnut (Jar),49000,11,6,43600,2000,FALSE,2,5400,1,4000,21.8,High,2,43600,87200
Munchies,Praakritik Organic Tuvar Dal,14000,0,6,14000,500,FALSE,500,0,1,250000,28,High,0.5,14000,7000000
Munchies,Sugarfree Gold Low Calorie Sweetner,18500,5,3,17500,300,FALSE,300,1000,1,90000,58.33,High,0.3,17500,5250000
Munchies,Cantina Beans Mexican Beans,25000,14,6,21300,410,FALSE,410,3700,1,168100,51.95,High,0.41,21300,8733000
Munchies,Pillsbury Oven Cake Mix - Vanilla,17500,10,6,15600,225,FALSE,225,1900,1,50625,69.33,High,0.225,15600,3510000
Munchies,Hershey's Chocolate Milk Booster,20000,0,6,20000,450,FALSE,450,0,1,202500,44.44,High,0.45,20000,9000000
Munchies,Popular Essentials Byadagi Chilli Stemless,8000,0,6,8000,100,FALSE,100,0,1,10000,80,High,0.1,8000,800000
Munchies,Suhana Spice Mix - Chicken Biryani,6600,0,6,6600,50,FALSE,50,0,1,2500,132,High,0.05,6600,330000
Munchies,Praakritik Organic Yellow Moon Dal,13500,0,6,13500,500,FALSE,500,0,1,250000,27,High,0.5,13500,6750000
Munchies,Maggi Magic Cubes Extra Chicken,19900,10,6,17900,240,FALSE,240,2000,1,57600,74.58,High,0.24,17900,4296000
Munchies,Dhara Filtered Groundnut Oil (Jar),105000,0,2,105000,5000,FALSE,5,0,1,25000,21,High,5,105000,525000
Munchies,24 Mantra Sona Masuri Brown Rice,47500,10,6,42300,5000,FALSE,5,5200,0.9,25000,8.46,High,5,42300,211500
Munchies,24 Mantra Organic Pancharatna Dal - Split,13000,7,6,12000,500,FALSE,500,1000,1,250000,24,High,0.5,12000,6000000
Munchies,24 Mantra Organic Cumin Powder,7000,0,6,7000,100,FALSE,100,0,1,10000,70,High,0.1,7000,700000
Munchies,Popular Essentials Samba Broken Wheat,10000,11,6,8900,500,FALSE,500,1100,1,250000,17.8,High,0.5,8900,4450000
Munchies,Betty Crocker Chocolate Fudge Cake Mix,29500,0,6,29500,475,FALSE,475,0,1,225625,62.11,High,0.475,29500,14012500
Munchies,Borges Extra Light Olive Oil Bottle ,260000,46,6,139900,2000,FALSE,2,120100,1,4000,69.95,High,2,139900,279800
Munchies,Flying Bird Premium Orange Artificial Food Essence,6000,0,6,6000,20,FALSE,20,0,1,400,300,High,0.02,6000,120000
Munchies,Popular Essentials Red Cherry/Gundu Chilli,9500,0,6,9500,100,FALSE,100,0,1,10000,95,High,0.1,9500,950000
Munchies,Super Saver Kolam Rice Sortex Clean ,70000,10,3,63000,5000,FALSE,5,7000,0.9,25000,12.6,High,5,63000,315000
Munchies,Flying Bird Food Essence - Kewra,5000,0,6,5000,20,FALSE,20,0,1,400,250,High,0.02,5000,100000
Munchies,MTR Vada Breakfast,20000,0,1,20000,500,FALSE,500,0,1,250000,40,High,0.5,20000,10000000
Munchies,On1y Pasta Seasoning,9900,0,6,9900,30,FALSE,30,0,1,900,330,High,0.03,9900,297000
Munchies,Praakritik Organic Indrayani Rice,7000,0,6,7000,500,FALSE,500,0,0.9,250000,14,High,0.5,7000,3500000
Munchies,On1y Pizza Seasoning,9900,0,6,9900,28,FALSE,28,0,1,784,353.57,High,0.028,9900,277200
Munchies,Kitchens of India Mutter Paneer Mix,12000,30,4,8400,285,FALSE,285,3600,1,81225,29.47,High,0.285,8400,2394000
Munchies,Aashirvaad Svasti Cow Ghee Tetra Pack,29500,0,6,29500,500,FALSE,500,0,1,250000,59,High,0.5,29500,14750000
Munchies,Weikfield Cooker Cake Mix - Vanilla,9500,0,6,9500,150,FALSE,150,0,1,22500,63.33,High,0.15,9500,1425000
Munchies,Praakritik Organic Kapli Wheat Atta,16500,10,6,14700,1000,FALSE,1,1800,0.9,1000,14.7,High,1,14700,14700
Munchies,Epicurea Sushi Rice,29500,0,6,29500,500,FALSE,500,0,1,250000,59,High,0.5,29500,14750000
Munchies,Sugarfree Natural Green Stevia Leaves Zero Calorie,7500,0,2,7500,100,FALSE,100,0,1,10000,75,High,0.1,7500,750000
Munchies,Smith & Jones Italian Spices Masala Mix,9900,0,6,9900,75,FALSE,75,0,1,5625,132,High,0.075,9900,742500
Munchies,Satyam Nighties Spices  Chilli Bore,8900,10,6,8000,100,FALSE,100,900,1,10000,80,High,0.1,8000,800000
Munchies,Weikfield Veg Jelly Crystals - Orange,4500,2,6,4400,90,FALSE,90,100,1,8100,48.89,High,0.09,4400,396000
Munchies,Praakritik Organic Jumbo Rolled Oats,19000,11,6,16900,500,FALSE,500,2100,1,250000,33.8,High,0.5,16900,8450000
Munchies,On1y Sea Salt Grinder,8900,0,6,8900,100,FALSE,100,0,1,10000,89,High,0.1,8900,890000
Munchies,Delight Nuts Berries Mix ,39900,20,6,31900,200,FALSE,200,8000,1,40000,159.5,High,0.2,31900,6380000
Munchies,Everest Kesari Milk Masala,20500,0,6,20500,50,FALSE,20,0,1,1000,410,High,0.05,20500,410000
Munchies,Praakritik Organic Ginger Powder,13900,10,6,12500,100,FALSE,100,1400,1,10000,125,High,0.1,12500,1250000
Munchies,Suhana Mutton Gravy Mix,4500,0,4,4500,80,FALSE,80,0,1,6400,56.25,High,0.08,4500,360000
Munchies,On1y Salad Seasoning Grinder,13900,0,6,13900,45,FALSE,45,0,1,2025,308.89,High,0.045,13900,625500
Munchies,Figaro Pure Olive Oil,32500,8,1,29900,200,FALSE,200,2600,1,40000,149.5,High,0.2,29900,5980000
Munchies,Madhur Sugar,6000,6,0,5600,1000,TRUE,1,400,0.8,1000,5.6,High,1,5600,5600
Munchies,Amul Fresh Cream,6300,0,0,6300,250,TRUE,250,0,1,62500,25.2,High,0.25,6300,1575000
Munchies,Madhur Pure And Hygienic Sugar,29500,9,0,26600,5000,TRUE,5,2900,0.8,25000,5.32,High,5,26600,133000
Munchies,Satyam Poha Jada,3500,8,0,3200,500,TRUE,500,300,0.9,250000,6.4,Medium,0.5,3200,1600000
Munchies,Aashirvaad Superior MP Whole Wheat Atta,5300,1,0,5200,1000,TRUE,1,100,0.8,1000,5.2,High,1,5200,5200
Munchies,Fortune Soyabean Oil,21000,13,0,18100,1000,TRUE,1,2900,1,1000,18.1,High,1,18100,18100
Munchies,Maggi Masala Ae Magic,5800,6,0,5400,72,TRUE,72,400,1,5184,75,High,0.072,5400,388800
Munchies,Aashirvaad Iodised Salt ,2200,13,0,1900,1000,TRUE,1,300,0.5,1000,1.9,Medium,1,1900,1900
Munchies,Maggi 2-Minute Instant Noodles - Masala,4400,0,0,4400,280,TRUE,280,0,0.9,78400,15.71,High,0.28,4400,1232000
Munchies,Popular Essentials Phool Makhana (Jumbo Size),15000,14,0,12800,100,TRUE,100,2200,1,10000,128,High,0.1,12800,1280000
Munchies,Aashirvaad Atta With Mutigrains,31500,8,0,28700,5000,TRUE,5,2800,0.8,25000,5.74,High,5,28700,143500
Munchies,Tata Sampann Poha,4400,6,0,4100,500,TRUE,500,300,0.9,250000,8.2,High,0.5,4100,2050000
Munchies,Fortune Besan Flour,12000,0,0,12000,1000,TRUE,1,0,0.9,1000,12,High,1,12000,12000
Munchies,Popular Essentials Toor Dal (Un-Polished),8000,7,0,7400,500,TRUE,500,600,0.9,250000,14.8,High,0.5,7400,3700000
Munchies,Everest Tikhalal Hot & Red Chilly Powder,4700,2,0,4600,100,TRUE,100,100,1,10000,46,High,0.1,4600,460000
Munchies,Popular Essentials Chia Seeds,5000,2,0,4900,100,TRUE,100,100,1,10000,49,High,0.1,4900,490000
Munchies,Tata Sampann Unpolished Toor Dal/Arhar Dal,17900,1,0,17700,1000,TRUE,200,200,0.9,200000,17.7,High,1,17700,3540000
Munchies,Everest Coriander Powder,3200,3,0,3100,100,TRUE,100,100,1,10000,31,Medium,0.1,3100,310000
Munchies,Satyam Thin Poha Patla,3800,7,0,3500,500,TRUE,500,300,0.9,250000,7,Medium,0.5,3500,1750000
Munchies,Popular Essentials Sona Masouri Raw Rice,7500,0,0,7500,1000,TRUE,1,0,0.9,1000,7.5,High,1,7500,7500
Munchies,Tata Sampann High Protien Chana Dal - Split,6400,0,0,6400,500,TRUE,500,0,0.9,250000,12.8,High,0.5,6400,3200000
Munchies,Satyam Singdana ,11900,6,0,11100,500,TRUE,500,800,1,250000,22.2,High,0.5,11100,5550000
Munchies,Tata Sampann Moong Chilka ,8800,6,0,8200,500,TRUE,500,600,0.9,250000,16.4,High,0.5,8200,4100000
Munchies,Tata Sampann High Protien Toor Dal - Split,9100,2,0,8900,500,TRUE,500,200,0.9,250000,17.8,High,0.5,8900,4450000
Munchies,Ching's Chow Mein Hakka Noodles Masala,1000,0,0,1000,20,TRUE,20,0,1,400,50,Low,0.02,1000,20000
Munchies,Everest Chat Masala,6500,9,0,5900,100,TRUE,100,600,1,10000,59,High,0.1,5900,590000
Munchies,Popular Essentials Black Brown Chana (Un-Polished),5500,9,0,5000,500,TRUE,500,500,0.9,250000,10,High,0.5,5000,2500000
Munchies,Dabur Ginger Garlic Paste,5000,6,0,4700,200,TRUE,200,300,1,40000,23.5,High,0.2,4700,940000
Munchies,Ching's Secret Veg Hakka Noodles,10700,0,0,10700,600,TRUE,600,0,0.9,360000,17.83,High,0.6,10700,6420000
Munchies,Saffola Oats 100 % Natural,1500,0,0,1500,38,TRUE,38,0,1,1444,39.47,Low,0.038,1500,57000
Munchies,Everest Kashmiri Lal Chilli Powder,31000,10,0,27900,500,TRUE,500,3100,1,250000,55.8,High,0.5,27900,13950000
Munchies,Popular Essentials Black Raisins Seedless,6000,10,0,5400,100,TRUE,100,600,1,10000,54,High,0.1,5400,540000
Munchies,Daawat Rozana Super Basmati Rice,7900,0,0,7900,1000,TRUE,1,0,0.9,1000,7.9,High,1,7900,7900
Munchies,Everest Cumin Powder (Jeera),3000,3,0,2900,50,TRUE,50,100,1,2500,58,Medium,0.05,2900,145000
Munchies,Everest Sambhar Masala,3400,2,0,3300,50,TRUE,50,100,1,2500,66,Medium,0.05,3300,165000
Munchies,Maggi Chilly Chow Cuppa Noodles,5000,0,0,5000,70,TRUE,70,0,1,4900,71.43,High,0.07,5000,350000
Munchies,Popular Essentials Mustard Seeds Rai Big,2000,0,0,2000,100,TRUE,100,0,1,10000,20,Medium,0.1,2000,200000
Munchies,Patanjali Cow's Ghee,56500,0,0,56500,1000,TRUE,1,0,1,1000,56.5,High,1,56500,56500
Munchies,Everest Amchur Powder,4200,2,0,4100,50,TRUE,50,100,1,2500,82,High,0.05,4100,205000
Munchies,Daawat Super Basmati Rice,18500,8,0,16900,1000,TRUE,1,1600,0.9,1000,16.9,High,1,16900,16900
Munchies,Popular Essentials Sabudana,6000,10,0,5400,500,TRUE,500,600,0.9,250000,10.8,High,0.5,5400,2700000
Munchies,Popular Essentials Brown Sugar,4000,0,0,4000,500,TRUE,500,0,0.9,250000,8,High,0.5,4000,2000000
Munchies,Everest Coriander Powder,7000,10,0,6300,200,TRUE,200,700,1,40000,31.5,High,0.2,6300,1260000
Munchies,Sunfeast Yippee! Magic Masala Noodles,4800,6,0,4500,240,TRUE,240,300,1,57600,18.75,High,0.24,4500,1080000
Munchies,Tata Tea Gold,3500,0,0,3500,100,TRUE,200,0,1,20000,35,Medium,0.1,3500,700000
Munchies,Daawat Rozana Gold Basmati Rice,9000,1,0,8900,1000,TRUE,1,100,0.9,1000,8.9,High,1,8900,8900
Munchies,Top Ramen Masala,9100,9,0,8200,560,TRUE,560,900,0.9,313600,14.64,High,0.56,8200,4592000
Munchies,Everest Turmeric Powder,6700,10,0,6000,200,TRUE,200,700,1,40000,30,High,0.2,6000,1200000
Munchies,Popular Essentials Buckwheat Flour (Kuttu Atta),12500,9,0,11300,500,TRUE,500,1200,1,250000,22.6,High,0.5,11300,5650000
Munchies,Keya Italian Pizza Oregano,10900,11,0,9700,80,TRUE,80,1200,1,6400,121.25,High,0.08,9700,776000
Munchies,Chef's Basket Durum Wheat Penne Pasta,16000,50,0,8000,500,TRUE,500,8000,1,250000,16,High,0.5,8000,4000000
Munchies,Tata Sampann Kala Chana,12500,0,0,12500,1000,TRUE,1,0,0.9,1000,12.5,High,1,12500,12500
Munchies,India Gate Basmati Rice,21000,0,0,21000,1000,TRUE,1,0,1,1000,21,High,1,21000,21000
Munchies,24 Mantra Organic Whole Wheat Atta,6400,7,0,5900,1000,TRUE,1,500,0.8,1000,5.9,High,1,5900,5900
Munchies,Zorabian Chicken Kheema Parathas,19000,0,0,19000,300,TRUE,300,0,1,90000,63.33,High,0.3,19000,5700000
Munchies,Sunfeast Pasta Treat Pack of Tomato Cheese,2800,17,0,2300,65,TRUE,65,500,1,4225,35.38,Medium,0.065,2300,149500
Munchies,Sugarlite 50% Less Calories Sugar Pouch,9900,40,0,5900,500,TRUE,500,4000,0.9,250000,11.8,High,0.5,5900,2950000
Munchies,Popular Essentials Sabja/Basil Seeds,6000,15,0,5100,100,TRUE,100,900,1,10000,51,High,0.1,5100,510000
Munchies,Patanjali Pure Honey,9500,0,0,9500,250,TRUE,250,0,1,62500,38,High,0.25,9500,2375000
Munchies,Weikfield Falooda Mix - Mango,4900,2,0,4800,200,TRUE,200,100,1,40000,24,High,0.2,4800,960000
Munchies,Pro Nature Organic Sonamasoori Brown Rice,10200,7,0,9400,1000,TRUE,1,800,0.9,1000,9.4,High,1,9400,9400
Munchies,Maggi Special Masala Spicy Yummy Noodles,7200,0,0,7200,280,TRUE,280,0,1,78400,25.71,High,0.28,7200,2016000
Munchies,Godrej Yummiez Chicken Breakfast Salami,15000,4,0,14300,250,TRUE,250,700,1,62500,57.2,High,0.25,14300,3575000
Munchies,Everest Saffron Kesar,12000,0,0,12000,1,TRUE,0,0,1,0,12000,High,0.001,12000,0
"Dairy, Bread & Batter",Mother Dairy Toned Milk Pouch,2500,0,4,2500,500,FALSE,500,0,0.8,250000,5,Medium,0.5,2500,1250000
"Dairy, Bread & Batter",Mother Dairy Classic Curd,3000,3,6,2900,400,FALSE,400,100,0.9,160000,7.25,Medium,0.4,2900,1160000
"Dairy, Bread & Batter",Mother Dairy Ultra Full Cream Milk,3100,0,4,3100,500,FALSE,500,0,0.8,250000,6.2,Medium,0.5,3100,1550000
"Dairy, Bread & Batter",Amul Butter - Pasteurised,5000,2,6,4900,100,FALSE,100,100,1,10000,49,High,0.1,4900,490000
"Dairy, Bread & Batter",Britannia Sandwich White Bread,3300,0,4,3300,350,FALSE,350,0,0.9,122500,9.43,Medium,0.35,3300,1155000
"Dairy, Bread & Batter",iD Curd Pouch,3500,2,6,3400,400,FALSE,400,100,0.9,160000,8.5,Medium,0.4,3400,1360000
"Dairy, Bread & Batter",iD Idli & Dosa Batter ,8000,15,6,6800,1000,FALSE,1,1200,0.9,1000,6.8,High,1,6800,6800
"Dairy, Bread & Batter",Britannia 100% Whole Wheat Bread,4500,0,4,4500,450,FALSE,450,0,0.9,202500,10,High,0.45,4500,2025000
"Dairy, Bread & Batter",Britannia Healthy Slice Sandwich Bread,4000,0,4,4000,450,FALSE,450,0,0.9,202500,8.89,High,0.45,4000,1800000
"Dairy, Bread & Batter",Gowardhan Classic Block Fresh Paneer,8900,8,6,8100,200,FALSE,200,800,1,40000,40.5,High,0.2,8100,1620000
"Dairy, Bread & Batter",Amul Processed Cheese Cubes,10600,4,6,10100,200,FALSE,200,500,1,40000,50.5,High,0.2,10100,2020000
"Dairy, Bread & Batter",Britannia Pav,2200,0,4,2200,250,FALSE,250,0,0.9,62500,8.8,Medium,0.25,2200,550000
"Dairy, Bread & Batter",Amul Butter - Pasteurised,24500,2,6,24000,500,FALSE,500,500,1,250000,48,High,0.5,24000,12000000
"Dairy, Bread & Batter",Arden Eggs White,9700,0,4,9700,696,FALSE,12,0,0.9,8352,13.94,High,0.696,9700,116400
"Dairy, Bread & Batter",Arden Eggs White,6500,15,4,5500,348,FALSE,6,1000,0.9,2088,15.8,High,0.348,5500,33000
"Dairy, Bread & Batter",Nestle A+ Nourish Dahi,3500,2,6,3400,200,FALSE,200,100,0.9,40000,17,Medium,0.2,3400,680000
"Dairy, Bread & Batter",Britannia Burger Bun with Sesame Seed,1500,0,4,1500,100,FALSE,100,0,0.9,10000,15,Low,0.1,1500,150000
"Dairy, Bread & Batter",Amul Frozen Malai Paneer,7500,2,6,7300,200,FALSE,200,200,1,40000,36.5,High,0.2,7300,1460000
"Dairy, Bread & Batter",iD Natural Paneer,10500,5,6,9900,200,FALSE,200,600,1,40000,49.5,High,0.2,9900,1980000
"Dairy, Bread & Batter",Britannia Fruit Bun,1700,0,3,1700,100,FALSE,100,0,0.9,10000,17,Low,0.1,1700,170000
"Dairy, Bread & Batter",Amul Cheese - Processed Slices,12200,1,6,12000,200,FALSE,200,200,1,40000,60,High,0.2,12000,2400000
"Dairy, Bread & Batter",iD Curd Cup,6000,0,6,6000,400,FALSE,400,0,0.9,160000,15,High,0.4,6000,2400000
"Dairy, Bread & Batter",The Bake Shop Premium White Sandwich Bread,3000,0,1,3000,400,FALSE,400,0,0.9,160000,7.5,Medium,0.4,3000,1200000
"Dairy, Bread & Batter",Britannia Multigrain Bread ,5500,0,4,5500,400,FALSE,400,0,0.9,160000,13.75,High,0.4,5500,2200000
"Dairy, Bread & Batter",Amul Processed Cheese Block,10600,0,6,10600,200,FALSE,200,0,1,40000,53,High,0.2,10600,2120000
"Dairy, Bread & Batter",Nestle A+ Nourish Dahi,7000,2,6,6800,400,FALSE,400,200,0.9,160000,17,High,0.4,6800,2720000
"Dairy, Bread & Batter",Arden Eggs Brown,8500,7,4,7900,348,FALSE,6,600,1,2088,22.7,High,0.348,7900,47400
"Dairy, Bread & Batter",Epigamia Misti Doi,3000,0,6,3000,85,FALSE,85,0,1,7225,35.29,Medium,0.085,3000,255000
"Dairy, Bread & Batter",Amul Cheese - Block,24500,2,6,24000,500,FALSE,500,500,1,250000,48,High,0.5,24000,12000000
"Dairy, Bread & Batter",Amul Butter - Pasteurised (School Pack),5900,3,6,5700,100,FALSE,100,200,1,10000,57,High,0.1,5700,570000
"Dairy, Bread & Batter",Britannia Brown Bread ,4200,0,4,4200,400,FALSE,400,0,0.9,160000,10.5,High,0.4,4200,1680000
"Dairy, Bread & Batter",Amul Fresh Cream,19700,3,3,19100,1000,FALSE,1,600,0.9,1000,19.1,High,1,19100,19100
"Dairy, Bread & Batter",Epigamia Natural Greek Yogurt,4500,0,6,4500,90,FALSE,90,0,1,8100,50,High,0.09,4500,405000
"Dairy, Bread & Batter",The Bake Shop Pizza Base,3000,0,1,3000,150,FALSE,150,0,1,22500,20,Medium,0.15,3000,450000
"Dairy, Bread & Batter",Amul Delicious Fat Spread - Cholesterol Free,1800,5,6,1700,100,FALSE,100,100,0.9,10000,17,Low,0.1,1700,170000
"Dairy, Bread & Batter",D'lecta Dairy Cream,5400,5,6,5100,200,FALSE,200,300,1,40000,25.5,High,0.2,5100,1020000
"Dairy, Bread & Batter",Nestle A+ Actiplus Probiotic Dahi Plain Curd,7800,3,5,7500,400,FALSE,400,300,0.9,160000,18.75,High,0.4,7500,3000000
"Dairy, Bread & Batter",Bio Nutrients Pure Diet Tofu Gold ,6000,5,5,5700,200,FALSE,200,300,1,40000,28.5,High,0.2,5700,1140000
"Dairy, Bread & Batter",Amul Delicious Fat Spread - Cholesterol Free,8800,2,2,8600,500,FALSE,500,200,0.9,250000,17.2,High,0.5,8600,4300000
"Dairy, Bread & Batter",Amul Mithai Mate Condensed Sweetened Milk,5600,3,4,5400,200,FALSE,200,200,1,40000,27,High,0.2,5400,1080000
"Dairy, Bread & Batter",Arden Desi Eggs,11000,13,4,9500,348,FALSE,6,1500,1,2088,27.3,High,0.348,9500,57000
"Dairy, Bread & Batter",Amul Cheese - Pepper,8500,3,6,8200,200,FALSE,200,300,1,40000,41,High,0.2,8200,1640000
"Dairy, Bread & Batter",Amul Cheese Spread Creamy,8500,5,6,8000,180,FALSE,180,500,1,32400,44.44,High,0.18,8000,1440000
"Dairy, Bread & Batter",The Bake Shop Foot Long,4000,0,1,4000,200,FALSE,200,0,1,40000,20,High,0.2,4000,800000
"Dairy, Bread & Batter",Amul Cheese Slices,36000,0,1,35900,750,FALSE,750,100,1,562500,47.87,High,0.75,35900,26925000
"Dairy, Bread & Batter",Suguna Sharp Egg ,7200,13,3,6200,348,FALSE,6,1000,1,2088,17.82,High,0.348,6200,37200
"Dairy, Bread & Batter",Amul Cheese Sauce Mexican Salsa,7500,4,1,7200,200,FALSE,200,300,1,40000,36,High,0.2,7200,1440000
"Dairy, Bread & Batter",Nestle Everyday Dairy Whitener,21000,0,4,21000,400,FALSE,400,0,1,160000,52.5,High,0.4,21000,8400000
"Dairy, Bread & Batter",Amul Pizza Cheese Processed,10900,4,6,10400,200,FALSE,200,500,1,40000,52,High,0.2,10400,2080000
"Dairy, Bread & Batter",Betty Crocker Complete Pancake Mix Original,11000,4,6,10500,250,FALSE,500,500,1,125000,42,High,0.25,10500,5250000
"Dairy, Bread & Batter",Amul Lite Spread,4000,2,5,3900,100,FALSE,100,100,1,10000,39,High,0.1,3900,390000
"Dairy, Bread & Batter",Go Cheese Slice - Plain,14000,5,6,13300,200,FALSE,200,700,1,40000,66.5,High,0.2,13300,2660000
"Dairy, Bread & Batter",Pillsbury Choco Chip Pancake Mix,9900,5,6,9400,165,FALSE,165,500,1,27225,56.97,High,0.165,9400,1551000
"Dairy, Bread & Batter",RRO Sour Cream,27500,50,4,13700,200,FALSE,200,13800,1,40000,68.5,High,0.2,13700,2740000
"Dairy, Bread & Batter",D'lecta Natural Feta Cheese Block,10000,5,4,9500,100,FALSE,100,500,1,10000,95,High,0.1,9500,950000
"Dairy, Bread & Batter",Suguna Active - DHA,7200,13,4,6200,348,FALSE,6,1000,1,2088,17.82,High,0.348,6200,37200
"Dairy, Bread & Batter",Go Cheese Processed Angles Plain,10000,5,6,9500,160,FALSE,160,500,1,25600,59.38,High,0.16,9500,1520000
"Dairy, Bread & Batter",Epigamia Greek Yogurt - Natural,20000,0,1,20000,400,FALSE,400,0,1,160000,50,High,0.4,20000,8000000
"Dairy, Bread & Batter",Amul Unsalted Cooking Butter,24500,2,6,23800,500,FALSE,500,700,1,250000,47.6,High,0.5,23800,11900000
"Dairy, Bread & Batter",The Whole Truth Dark Chocolate Peanut Butter - Creamy,23500,25,6,17400,325,FALSE,325,6100,1,105625,53.54,High,0.325,17400,5655000
"Dairy, Bread & Batter",The Laughing Cow Cheese Slices,15500,0,2,15500,200,FALSE,200,0,1,40000,77.5,High,0.2,15500,3100000
"Dairy, Bread & Batter",Epigamia Almond Milk Unsweetened Dairy Free,30000,33,4,19900,1000,FALSE,1,10100,1,1000,19.9,High,1,19900,19900
"Dairy, Bread & Batter",Go Cheese  Spread Plain,9900,5,6,9400,200,FALSE,200,500,1,40000,47,High,0.2,9400,1880000
"Dairy, Bread & Batter",So Good Almond Milk - Natural Unsweetened,7000,0,4,7000,200,FALSE,200,0,1,40000,35,High,0.2,7000,1400000
"Dairy, Bread & Batter",Amul Cheese Sauce Jalapeno,7500,0,5,7500,200,FALSE,200,0,1,40000,37.5,High,0.2,7500,1500000
"Dairy, Bread & Batter",D'lecta Cream Cheese,16900,4,4,16100,150,FALSE,150,800,1,22500,107.33,High,0.15,16100,2415000
"Dairy, Bread & Batter",Dlecta Natural Cheddar Slices,19900,5,6,18900,200,FALSE,200,1000,1,40000,94.5,High,0.2,18900,3780000
"Dairy, Bread & Batter",Suguna Heart- Omega3,7200,13,4,6200,348,FALSE,6,1000,1,2088,17.82,High,0.348,6200,37200
"Dairy, Bread & Batter",Go Cheese Spread - Garlic,9900,5,6,9400,200,FALSE,200,500,1,40000,47,High,0.2,9400,1880000
"Dairy, Bread & Batter",Go Pizza Cheese,14000,5,6,13300,200,FALSE,200,700,1,40000,66.5,High,0.2,13300,2660000
"Dairy, Bread & Batter",RRO Cheddar Block Cheese,29500,50,6,14700,200,FALSE,200,14800,1,40000,73.5,High,0.2,14700,2940000
"Dairy, Bread & Batter",The Whole Truth Peanut Butter With Dates - Creamy No Sugar,21500,9,6,19400,325,FALSE,325,2100,1,105625,59.69,High,0.325,19400,6305000
"Dairy, Bread & Batter",Suguna Fit Egg,12000,43,4,6800,348,FALSE,6,5200,1,2088,19.54,High,0.348,6800,40800
"Dairy, Bread & Batter",Pantai Coconut Cream,15000,4,4,14300,400,FALSE,400,700,1,160000,35.75,High,0.4,14300,5720000
"Dairy, Bread & Batter",RRO Fresh Ricotta,27500,50,6,13700,200,FALSE,200,13800,1,40000,68.5,High,0.2,13700,2740000
"Dairy, Bread & Batter",Dlecta Cheese Cubes 2,14500,5,6,13700,200,FALSE,200,800,1,40000,68.5,High,0.2,13700,2740000
"Dairy, Bread & Batter",RRO Mozzarella Pizza Cheese,27500,50,6,13700,200,FALSE,200,13800,1,40000,68.5,High,0.2,13700,2740000
"Dairy, Bread & Batter",The Laughing Cow Cheese Cubes,15000,0,4,15000,200,FALSE,200,0,1,40000,75,High,0.2,15000,3000000
"Dairy, Bread & Batter",Yogabar 100% Pure Peanut Butter Creamy & Yummy Unsweetened,22900,10,6,20600,400,FALSE,400,2300,1,160000,51.5,High,0.4,20600,8240000
"Dairy, Bread & Batter",RRO Burrata Cheese,25000,50,4,12500,200,FALSE,200,12500,1,40000,62.5,High,0.2,12500,2500000
"Dairy, Bread & Batter",The Whole Truth Dark Chocolate Peanut Butter - Crunchy,23500,20,5,18800,325,FALSE,325,4700,1,105625,57.85,High,0.325,18800,6110000
"Dairy, Bread & Batter",Go Cheese Processed Squares,12500,5,6,11800,200,FALSE,200,700,1,40000,59,High,0.2,11800,2360000
"Dairy, Bread & Batter",Funfoods Peanut Butter Crunchy,16900,7,1,15600,400,FALSE,400,1300,1,160000,39,High,0.4,15600,6240000
"Dairy, Bread & Batter",Amul Safed Makkhan,23500,1,6,23200,500,FALSE,500,300,1,250000,46.4,High,0.5,23200,11600000
"Dairy, Bread & Batter",Go Cheese Spread - Four Pepper (Soft & Creamy),9900,5,6,9400,200,FALSE,200,500,1,40000,47,High,0.2,9400,1880000
"Dairy, Bread & Batter",Dlicia Whip Topping Bottle,23500,27,5,17100,1000,FALSE,1,6400,1,1000,17.1,High,1,17100,17100
"Dairy, Bread & Batter",Amulya Dairy Whitener ,38000,2,4,37200,1000,FALSE,1,800,1,1000,37.2,High,1,37200,37200
"Dairy, Bread & Batter",Laughing Cow Cheese 8 Portion 120Gm Imported,11000,0,6,11000,120,FALSE,120,0,1,14400,91.67,High,0.12,11000,1320000
"Dairy, Bread & Batter",The Whole Truth Peanut Butter - Sweetened & Crunchy,21500,20,6,17200,325,FALSE,325,4300,1,105625,52.92,High,0.325,17200,5590000
"Dairy, Bread & Batter",Go Processed Cheese Block,12500,4,6,11900,200,FALSE,200,600,1,40000,59.5,High,0.2,11900,2380000
"Dairy, Bread & Batter",Go Cheese Processed Block,24900,4,6,23700,400,FALSE,400,1200,1,160000,59.25,High,0.4,23700,9480000
"Dairy, Bread & Batter",RRO Goat Milk Fetta Cheee,34500,31,6,23700,100,FALSE,100,10800,1,10000,237,High,0.1,23700,2370000
"Dairy, Bread & Batter",RRO Mascarpone Cheese,35500,50,6,17700,200,FALSE,200,17800,1,40000,88.5,High,0.2,17700,3540000
"Dairy, Bread & Batter",D'lecta Cheddar Cheese,19900,5,6,18900,200,FALSE,200,1000,1,40000,94.5,High,0.2,18900,3780000
"Dairy, Bread & Batter",Funfoods Peanut Butter Creamy,16900,0,1,16900,400,FALSE,400,0,1,160000,42.25,High,0.4,16900,6760000
"Dairy, Bread & Batter",Pantai Coconut Milk,15000,0,4,15000,400,FALSE,400,0,1,160000,37.5,High,0.4,15000,6000000
"Dairy, Bread & Batter",Dlecta Cheese Block,14500,0,6,14500,200,FALSE,200,0,1,40000,72.5,High,0.2,14500,2900000
"Dairy, Bread & Batter",President Butter - Salted,5400,0,6,5400,100,FALSE,100,0,1,10000,54,High,0.1,5400,540000
"Dairy, Bread & Batter",The Laughing Cow Plain Processed Cheese Block,15000,0,6,15000,200,FALSE,200,0,1,40000,75,High,0.2,15000,3000000
"Dairy, Bread & Batter",Yoga Bar Peanut Butter Dark Chocolate Jar,24900,0,4,24900,400,FALSE,400,0,1,160000,62.25,High,0.4,24900,9960000
"Dairy, Bread & Batter",The Laughing Cow Cheese Spread Plain,11000,0,6,11000,180,FALSE,180,0,1,32400,61.11,High,0.18,11000,1980000
"Dairy, Bread & Batter",Amul Malai Paneer Fresh ,7600,3,0,7300,200,TRUE,200,300,1,40000,36.5,High,0.2,7300,1460000
"Dairy, Bread & Batter",Amul Taaza Toned Homogenised Milk,6600,3,0,6400,1000,TRUE,1,200,0.8,1000,6.4,High,1,6400,6400
"Dairy, Bread & Batter",Amul Fresh Cream,6300,0,0,6300,250,TRUE,250,0,1,62500,25.2,High,0.25,6300,1575000
"Dairy, Bread & Batter",Amul Lactose Free Milk,2500,4,0,2400,250,TRUE,250,100,0.9,62500,9.6,Medium,0.25,2400,600000
"Dairy, Bread & Batter",The Bake Shop Whole Wheat Bread,4000,0,0,4000,400,TRUE,400,0,0.9,160000,10,High,0.4,4000,1600000
"Dairy, Bread & Batter",Amul Slim Trim Skimmed Milk,7500,0,0,7500,1000,TRUE,1,0,0.9,1000,7.5,High,1,7500,7500
"Dairy, Bread & Batter",Amul Cheese Slices,7100,1,0,7000,100,TRUE,100,100,1,10000,70,High,0.1,7000,700000
"Dairy, Bread & Batter",Amul Pizza Cheese - Mozzarella,10000,1,0,9900,200,TRUE,200,100,1,40000,49.5,High,0.2,9900,1980000
"Dairy, Bread & Batter",The Bake Shop Pizza Base Whole Wheat,3000,0,0,3000,150,TRUE,150,0,1,22500,20,Medium,0.15,3000,450000
"Dairy, Bread & Batter",Nestle A+ Slim Dahi - Low Fat,7800,3,0,7500,400,TRUE,400,300,0.9,160000,18.75,High,0.4,7500,3000000
"Dairy, Bread & Batter",Britannia Cheese Garlic Bread,3500,0,0,3500,300,TRUE,300,0,0.9,90000,11.67,Medium,0.3,3500,1050000
"Dairy, Bread & Batter",The Bake Shop Whole Wheat Ladi Pav,4000,0,0,4000,200,TRUE,200,0,1,40000,20,High,0.2,4000,800000
"Dairy, Bread & Batter",Amul Cheese Spread Yummy Plain,8500,0,0,8500,200,TRUE,200,0,1,40000,42.5,High,0.2,8500,1700000
"Dairy, Bread & Batter",Britannia Atta Kulcha,3000,0,0,3000,250,TRUE,250,0,0.9,62500,12,Medium,0.25,3000,750000
"Dairy, Bread & Batter",Suguna Nourish Egg,6200,0,0,6200,696,TRUE,12,0,0.9,8352,8.91,High,0.696,6200,74400
"Dairy, Bread & Batter",The Bake Shop Multi Grain Bread,6500,0,0,6500,400,TRUE,400,0,0.9,160000,16.25,High,0.4,6500,2600000
"Dairy, Bread & Batter",Nestle A+ Slim Milk,8900,0,0,8900,1000,TRUE,1,0,0.9,1000,8.9,High,1,8900,8900
"Dairy, Bread & Batter",Go Cheese Pizza Blend Mozzarella + Cheddar,12500,5,0,11800,200,TRUE,200,700,1,40000,59,High,0.2,11800,2360000
"Dairy, Bread & Batter",The Whole Truth Peanut Butter - Unsweetened & Crunchy,18500,20,0,14800,325,TRUE,325,3700,1,105625,45.54,High,0.325,14800,4810000
"Dairy, Bread & Batter",Amul Cheese Spread Spicy Garlic,8500,3,0,8200,200,TRUE,200,300,1,40000,41,High,0.2,8200,1640000
"Dairy, Bread & Batter",The Bake Shop Burger Buns,2000,0,0,2000,100,TRUE,100,0,1,10000,20,Medium,0.1,2000,200000
"Dairy, Bread & Batter",D'lecta Shredded Mozzarella Cheese,10000,5,0,9500,140,TRUE,140,500,1,19600,67.86,High,0.14,9500,1330000
"Dairy, Bread & Batter",Britannia Burger Bun with Sesame Seed,3000,0,0,3000,200,TRUE,200,0,0.9,40000,15,Medium,0.2,3000,600000
"Dairy, Bread & Batter",Suguna Vitamin D Egg,7500,17,0,6200,348,TRUE,6,1300,1,2088,17.82,High,0.348,6200,37200
"Dairy, Bread & Batter",Pillsbury Pancake Mix - Funfetti,9900,11,0,8800,162,TRUE,162,1100,1,26244,54.32,High,0.162,8800,1425600
"Dairy, Bread & Batter",Prabhat Malai Paneer Pouch,8000,0,0,8000,200,TRUE,200,0,1,40000,40,High,0.2,8000,1600000
"Dairy, Bread & Batter",Suguna Nourish Egg ,7200,16,0,6000,348,TRUE,6,1200,1,2088,17.24,High,0.348,6000,36000
"Dairy, Bread & Batter",RRO Mozzarella Block Cheese,29500,50,0,14700,200,TRUE,200,14800,1,40000,73.5,High,0.2,14700,2940000
Beverages,Mother Dairy Toned Milk Pouch,2500,0,4,2500,500,FALSE,500,0,0.8,250000,5,Medium,0.5,2500,1250000
Beverages,Mother Dairy Classic Curd,3000,3,6,2900,400,FALSE,400,100,0.9,160000,7.25,Medium,0.4,2900,1160000
Beverages,Mother Dairy Ultra Full Cream Milk,3100,0,4,3100,500,FALSE,500,0,0.8,250000,6.2,Medium,0.5,3100,1550000
Beverages,Amul Butter - Pasteurised,5000,2,6,4900,100,FALSE,100,100,1,10000,49,High,0.1,4900,490000
Beverages,Britannia Sandwich White Bread,3300,0,4,3300,350,FALSE,350,0,0.9,122500,9.43,Medium,0.35,3300,1155000
Beverages,iD Curd Pouch,3500,2,6,3400,400,FALSE,400,100,0.9,160000,8.5,Medium,0.4,3400,1360000
Beverages,iD Idli & Dosa Batter ,8000,15,6,6800,1000,FALSE,1,1200,0.9,1000,6.8,High,1,6800,6800
Beverages,Britannia 100% Whole Wheat Bread,4500,0,4,4500,450,FALSE,450,0,0.9,202500,10,High,0.45,4500,2025000
Beverages,Britannia Healthy Slice Sandwich Bread,4000,0,4,4000,450,FALSE,450,0,0.9,202500,8.89,High,0.45,4000,1800000
Beverages,Gowardhan Classic Block Fresh Paneer,8900,8,6,8100,200,FALSE,200,800,1,40000,40.5,High,0.2,8100,1620000
Beverages,Amul Processed Cheese Cubes,10600,4,6,10100,200,FALSE,200,500,1,40000,50.5,High,0.2,10100,2020000
Beverages,Britannia Pav,2200,0,4,2200,250,FALSE,250,0,0.9,62500,8.8,Medium,0.25,2200,550000
Beverages,Amul Butter - Pasteurised,24500,2,6,24000,500,FALSE,500,500,1,250000,48,High,0.5,24000,12000000
Beverages,Arden Eggs White,9700,0,4,9700,696,FALSE,12,0,0.9,8352,13.94,High,0.696,9700,116400
Beverages,Arden Eggs White,6500,15,4,5500,348,FALSE,6,1000,0.9,2088,15.8,High,0.348,5500,33000
Beverages,Nestle A+ Nourish Dahi,3500,2,6,3400,200,FALSE,200,100,0.9,40000,17,Medium,0.2,3400,680000
Beverages,Britannia Burger Bun with Sesame Seed,1500,0,4,1500,100,FALSE,100,0,0.9,10000,15,Low,0.1,1500,150000
Beverages,Amul Frozen Malai Paneer,7500,2,6,7300,200,FALSE,200,200,1,40000,36.5,High,0.2,7300,1460000
Beverages,iD Natural Paneer,10500,5,6,9900,200,FALSE,200,600,1,40000,49.5,High,0.2,9900,1980000
Beverages,Britannia Fruit Bun,1700,0,3,1700,100,FALSE,100,0,0.9,10000,17,Low,0.1,1700,170000
Beverages,Amul Cheese - Processed Slices,12200,1,6,12000,200,FALSE,200,200,1,40000,60,High,0.2,12000,2400000
Beverages,iD Curd Cup,6000,0,6,6000,400,FALSE,400,0,0.9,160000,15,High,0.4,6000,2400000
Beverages,The Bake Shop Premium White Sandwich Bread,3000,0,1,3000,400,FALSE,400,0,0.9,160000,7.5,Medium,0.4,3000,1200000
Beverages,Britannia Multigrain Bread ,5500,0,4,5500,400,FALSE,400,0,0.9,160000,13.75,High,0.4,5500,2200000
Beverages,Amul Processed Cheese Block,10600,0,6,10600,200,FALSE,200,0,1,40000,53,High,0.2,10600,2120000
Beverages,Nestle A+ Nourish Dahi,7000,2,6,6800,400,FALSE,400,200,0.9,160000,17,High,0.4,6800,2720000
Beverages,Arden Eggs Brown,8500,7,4,7900,348,FALSE,6,600,1,2088,22.7,High,0.348,7900,47400
Beverages,Epigamia Misti Doi,3000,0,6,3000,85,FALSE,85,0,1,7225,35.29,Medium,0.085,3000,255000
Beverages,Amul Cheese - Block,24500,2,6,24000,500,FALSE,500,500,1,250000,48,High,0.5,24000,12000000
Beverages,Amul Butter - Pasteurised (School Pack),5900,3,6,5700,100,FALSE,100,200,1,10000,57,High,0.1,5700,570000
Beverages,Britannia Brown Bread ,4200,0,4,4200,400,FALSE,400,0,0.9,160000,10.5,High,0.4,4200,1680000
Beverages,Amul Fresh Cream,19700,3,3,19100,1000,FALSE,1,600,0.9,1000,19.1,High,1,19100,19100
Beverages,Epigamia Natural Greek Yogurt,4500,0,6,4500,90,FALSE,90,0,1,8100,50,High,0.09,4500,405000
Beverages,The Bake Shop Pizza Base,3000,0,1,3000,150,FALSE,150,0,1,22500,20,Medium,0.15,3000,450000
Beverages,Amul Delicious Fat Spread - Cholesterol Free,1800,5,6,1700,100,FALSE,100,100,0.9,10000,17,Low,0.1,1700,170000
Beverages,D'lecta Dairy Cream,5400,5,6,5100,200,FALSE,200,300,1,40000,25.5,High,0.2,5100,1020000
Beverages,Nestle A+ Actiplus Probiotic Dahi Plain Curd,7800,3,5,7500,400,FALSE,400,300,0.9,160000,18.75,High,0.4,7500,3000000
Beverages,Bio Nutrients Pure Diet Tofu Gold ,6000,5,5,5700,200,FALSE,200,300,1,40000,28.5,High,0.2,5700,1140000
Beverages,Amul Delicious Fat Spread - Cholesterol Free,8800,2,2,8600,500,FALSE,500,200,0.9,250000,17.2,High,0.5,8600,4300000
Beverages,Amul Mithai Mate Condensed Sweetened Milk,5600,3,4,5400,200,FALSE,200,200,1,40000,27,High,0.2,5400,1080000
Beverages,Arden Desi Eggs,11000,13,4,9500,348,FALSE,6,1500,1,2088,27.3,High,0.348,9500,57000
Beverages,Amul Cheese - Pepper,8500,3,6,8200,200,FALSE,200,300,1,40000,41,High,0.2,8200,1640000
Beverages,Amul Cheese Spread Creamy,8500,5,6,8000,180,FALSE,180,500,1,32400,44.44,High,0.18,8000,1440000
Beverages,The Bake Shop Foot Long,4000,0,1,4000,200,FALSE,200,0,1,40000,20,High,0.2,4000,800000
Beverages,Amul Cheese Slices,36000,0,1,35900,750,FALSE,750,100,1,562500,47.87,High,0.75,35900,26925000
Beverages,Suguna Sharp Egg ,7200,13,3,6200,348,FALSE,6,1000,1,2088,17.82,High,0.348,6200,37200
Beverages,Amul Cheese Sauce Mexican Salsa,7500,4,1,7200,200,FALSE,200,300,1,40000,36,High,0.2,7200,1440000
Beverages,Nestle Everyday Dairy Whitener,21000,0,4,21000,400,FALSE,400,0,1,160000,52.5,High,0.4,21000,8400000
Beverages,Amul Pizza Cheese Processed,10900,4,6,10400,200,FALSE,200,500,1,40000,52,High,0.2,10400,2080000
Beverages,Betty Crocker Complete Pancake Mix Original,11000,4,6,10500,250,FALSE,500,500,1,125000,42,High,0.25,10500,5250000
Beverages,Amul Lite Spread,4000,2,5,3900,100,FALSE,100,100,1,10000,39,High,0.1,3900,390000
Beverages,Go Cheese Slice - Plain,14000,5,6,13300,200,FALSE,200,700,1,40000,66.5,High,0.2,13300,2660000
Beverages,Pillsbury Choco Chip Pancake Mix,9900,5,6,9400,165,FALSE,165,500,1,27225,56.97,High,0.165,9400,1551000
Beverages,RRO Sour Cream,27500,50,4,13700,200,FALSE,200,13800,1,40000,68.5,High,0.2,13700,2740000
Beverages,D'lecta Natural Feta Cheese Block,10000,5,4,9500,100,FALSE,100,500,1,10000,95,High,0.1,9500,950000
Beverages,Suguna Active - DHA,7200,13,4,6200,348,FALSE,6,1000,1,2088,17.82,High,0.348,6200,37200
Beverages,Go Cheese Processed Angles Plain,10000,5,6,9500,160,FALSE,160,500,1,25600,59.38,High,0.16,9500,1520000
Beverages,Epigamia Greek Yogurt - Natural,20000,0,1,20000,400,FALSE,400,0,1,160000,50,High,0.4,20000,8000000
Beverages,Amul Unsalted Cooking Butter,24500,2,6,23800,500,FALSE,500,700,1,250000,47.6,High,0.5,23800,11900000
Beverages,The Whole Truth Dark Chocolate Peanut Butter - Creamy,23500,25,6,17400,325,FALSE,325,6100,1,105625,53.54,High,0.325,17400,5655000
Beverages,The Laughing Cow Cheese Slices,15500,0,2,15500,200,FALSE,200,0,1,40000,77.5,High,0.2,15500,3100000
Beverages,Epigamia Almond Milk Unsweetened Dairy Free,30000,33,4,19900,1000,FALSE,1,10100,1,1000,19.9,High,1,19900,19900
Beverages,Go Cheese  Spread Plain,9900,5,6,9400,200,FALSE,200,500,1,40000,47,High,0.2,9400,1880000
Beverages,So Good Almond Milk - Natural Unsweetened,7000,0,4,7000,200,FALSE,200,0,1,40000,35,High,0.2,7000,1400000
Beverages,Amul Cheese Sauce Jalapeno,7500,0,5,7500,200,FALSE,200,0,1,40000,37.5,High,0.2,7500,1500000
Beverages,D'lecta Cream Cheese,16900,4,4,16100,150,FALSE,150,800,1,22500,107.33,High,0.15,16100,2415000
Beverages,Dlecta Natural Cheddar Slices,19900,5,6,18900,200,FALSE,200,1000,1,40000,94.5,High,0.2,18900,3780000
Beverages,Suguna Heart- Omega3,7200,13,4,6200,348,FALSE,6,1000,1,2088,17.82,High,0.348,6200,37200
Beverages,Go Cheese Spread - Garlic,9900,5,6,9400,200,FALSE,200,500,1,40000,47,High,0.2,9400,1880000
Beverages,Go Pizza Cheese,14000,5,6,13300,200,FALSE,200,700,1,40000,66.5,High,0.2,13300,2660000
Beverages,RRO Cheddar Block Cheese,29500,50,6,14700,200,FALSE,200,14800,1,40000,73.5,High,0.2,14700,2940000
Beverages,The Whole Truth Peanut Butter With Dates - Creamy No Sugar,21500,9,6,19400,325,FALSE,325,2100,1,105625,59.69,High,0.325,19400,6305000
Beverages,Suguna Fit Egg,12000,43,4,6800,348,FALSE,6,5200,1,2088,19.54,High,0.348,6800,40800
Beverages,Pantai Coconut Cream,15000,4,4,14300,400,FALSE,400,700,1,160000,35.75,High,0.4,14300,5720000
Beverages,RRO Fresh Ricotta,27500,50,6,13700,200,FALSE,200,13800,1,40000,68.5,High,0.2,13700,2740000
Beverages,Dlecta Cheese Cubes 2,14500,5,6,13700,200,FALSE,200,800,1,40000,68.5,High,0.2,13700,2740000
Beverages,RRO Mozzarella Pizza Cheese,27500,50,6,13700,200,FALSE,200,13800,1,40000,68.5,High,0.2,13700,2740000
Beverages,The Laughing Cow Cheese Cubes,15000,0,4,15000,200,FALSE,200,0,1,40000,75,High,0.2,15000,3000000
Beverages,Yogabar 100% Pure Peanut Butter Creamy & Yummy Unsweetened,22900,10,6,20600,400,FALSE,400,2300,1,160000,51.5,High,0.4,20600,8240000
Beverages,RRO Burrata Cheese,25000,50,4,12500,200,FALSE,200,12500,1,40000,62.5,High,0.2,12500,2500000
Beverages,The Whole Truth Dark Chocolate Peanut Butter - Crunchy,23500,20,5,18800,325,FALSE,325,4700,1,105625,57.85,High,0.325,18800,6110000
Beverages,Go Cheese Processed Squares,12500,5,6,11800,200,FALSE,200,700,1,40000,59,High,0.2,11800,2360000
Beverages,Funfoods Peanut Butter Crunchy,16900,7,1,15600,400,FALSE,400,1300,1,160000,39,High,0.4,15600,6240000
Beverages,Amul Safed Makkhan,23500,1,6,23200,500,FALSE,500,300,1,250000,46.4,High,0.5,23200,11600000
Beverages,Go Cheese Spread - Four Pepper (Soft & Creamy),9900,5,6,9400,200,FALSE,200,500,1,40000,47,High,0.2,9400,1880000
Beverages,Dlicia Whip Topping Bottle,23500,27,5,17100,1000,FALSE,1,6400,1,1000,17.1,High,1,17100,17100
Beverages,Amulya Dairy Whitener ,38000,2,4,37200,1000,FALSE,1,800,1,1000,37.2,High,1,37200,37200
Beverages,Laughing Cow Cheese 8 Portion 120Gm Imported,11000,0,6,11000,120,FALSE,120,0,1,14400,91.67,High,0.12,11000,1320000
Beverages,The Whole Truth Peanut Butter - Sweetened & Crunchy,21500,20,6,17200,325,FALSE,325,4300,1,105625,52.92,High,0.325,17200,5590000
Beverages,Go Processed Cheese Block,12500,4,6,11900,200,FALSE,200,600,1,40000,59.5,High,0.2,11900,2380000
Beverages,Go Cheese Processed Block,24900,4,6,23700,400,FALSE,400,1200,1,160000,59.25,High,0.4,23700,9480000
Beverages,RRO Goat Milk Fetta Cheee,34500,31,6,23700,100,FALSE,100,10800,1,10000,237,High,0.1,23700,2370000
Beverages,RRO Mascarpone Cheese,35500,50,6,17700,200,FALSE,200,17800,1,40000,88.5,High,0.2,17700,3540000
Beverages,D'lecta Cheddar Cheese,19900,5,6,18900,200,FALSE,200,1000,1,40000,94.5,High,0.2,18900,3780000
Beverages,Funfoods Peanut Butter Creamy,16900,0,1,16900,400,FALSE,400,0,1,160000,42.25,High,0.4,16900,6760000
Beverages,Pantai Coconut Milk,15000,0,4,15000,400,FALSE,400,0,1,160000,37.5,High,0.4,15000,6000000
Beverages,Dlecta Cheese Block,14500,0,6,14500,200,FALSE,200,0,1,40000,72.5,High,0.2,14500,2900000
Beverages,President Butter - Salted,5400,0,6,5400,100,FALSE,100,0,1,10000,54,High,0.1,5400,540000
Beverages,The Laughing Cow Plain Processed Cheese Block,15000,0,6,15000,200,FALSE,200,0,1,40000,75,High,0.2,15000,3000000
Beverages,Yoga Bar Peanut Butter Dark Chocolate Jar,24900,0,4,24900,400,FALSE,400,0,1,160000,62.25,High,0.4,24900,9960000
Beverages,The Laughing Cow Cheese Spread Plain,11000,0,6,11000,180,FALSE,180,0,1,32400,61.11,High,0.18,11000,1980000
Beverages,Amul Malai Paneer Fresh ,7600,3,0,7300,200,TRUE,200,300,1,40000,36.5,High,0.2,7300,1460000
Beverages,Amul Taaza Toned Homogenised Milk,6600,3,0,6400,1000,TRUE,1,200,0.8,1000,6.4,High,1,6400,6400
Beverages,Amul Fresh Cream,6300,0,0,6300,250,TRUE,250,0,1,62500,25.2,High,0.25,6300,1575000
Beverages,Amul Lactose Free Milk,2500,4,0,2400,250,TRUE,250,100,0.9,62500,9.6,Medium,0.25,2400,600000
Beverages,The Bake Shop Whole Wheat Bread,4000,0,0,4000,400,TRUE,400,0,0.9,160000,10,High,0.4,4000,1600000
Beverages,Amul Slim Trim Skimmed Milk,7500,0,0,7500,1000,TRUE,1,0,0.9,1000,7.5,High,1,7500,7500
Beverages,Amul Cheese Slices,7100,1,0,7000,100,TRUE,100,100,1,10000,70,High,0.1,7000,700000
Beverages,Amul Pizza Cheese - Mozzarella,10000,1,0,9900,200,TRUE,200,100,1,40000,49.5,High,0.2,9900,1980000
Beverages,The Bake Shop Pizza Base Whole Wheat,3000,0,0,3000,150,TRUE,150,0,1,22500,20,Medium,0.15,3000,450000
Beverages,Nestle A+ Slim Dahi - Low Fat,7800,3,0,7500,400,TRUE,400,300,0.9,160000,18.75,High,0.4,7500,3000000
Beverages,Britannia Cheese Garlic Bread,3500,0,0,3500,300,TRUE,300,0,0.9,90000,11.67,Medium,0.3,3500,1050000
Beverages,The Bake Shop Whole Wheat Ladi Pav,4000,0,0,4000,200,TRUE,200,0,1,40000,20,High,0.2,4000,800000
Beverages,Amul Cheese Spread Yummy Plain,8500,0,0,8500,200,TRUE,200,0,1,40000,42.5,High,0.2,8500,1700000
Beverages,Britannia Atta Kulcha,3000,0,0,3000,250,TRUE,250,0,0.9,62500,12,Medium,0.25,3000,750000
Beverages,Suguna Nourish Egg,6200,0,0,6200,696,TRUE,12,0,0.9,8352,8.91,High,0.696,6200,74400
Beverages,The Bake Shop Multi Grain Bread,6500,0,0,6500,400,TRUE,400,0,0.9,160000,16.25,High,0.4,6500,2600000
Beverages,Nestle A+ Slim Milk,8900,0,0,8900,1000,TRUE,1,0,0.9,1000,8.9,High,1,8900,8900
Beverages,Go Cheese Pizza Blend Mozzarella + Cheddar,12500,5,0,11800,200,TRUE,200,700,1,40000,59,High,0.2,11800,2360000
Beverages,The Whole Truth Peanut Butter - Unsweetened & Crunchy,18500,20,0,14800,325,TRUE,325,3700,1,105625,45.54,High,0.325,14800,4810000
Beverages,Amul Cheese Spread Spicy Garlic,8500,3,0,8200,200,TRUE,200,300,1,40000,41,High,0.2,8200,1640000
Beverages,The Bake Shop Burger Buns,2000,0,0,2000,100,TRUE,100,0,1,10000,20,Medium,0.1,2000,200000
Beverages,D'lecta Shredded Mozzarella Cheese,10000,5,0,9500,140,TRUE,140,500,1,19600,67.86,High,0.14,9500,1330000
Beverages,Britannia Burger Bun with Sesame Seed,3000,0,0,3000,200,TRUE,200,0,0.9,40000,15,Medium,0.2,3000,600000
Beverages,Suguna Vitamin D Egg,7500,17,0,6200,348,TRUE,6,1300,1,2088,17.82,High,0.348,6200,37200
Beverages,Pillsbury Pancake Mix - Funfetti,9900,11,0,8800,162,TRUE,162,1100,1,26244,54.32,High,0.162,8800,1425600
Beverages,Prabhat Malai Paneer Pouch,8000,0,0,8000,200,TRUE,200,0,1,40000,40,High,0.2,8000,1600000
Beverages,Suguna Nourish Egg ,7200,16,0,6000,348,TRUE,6,1200,1,2088,17.24,High,0.348,6000,36000
Beverages,RRO Mozzarella Block Cheese,29500,50,0,14700,200,TRUE,200,14800,1,40000,73.5,High,0.2,14700,2940000
Packaged Food,Maggi 2 Minute Masala Noodles,1200,0,6,1200,70,FALSE,70,0,0.9,4900,17.14,Low,0.07,1200,84000
Packaged Food,iD Idli & Dosa Batter ,8000,15,6,6800,1000,FALSE,1,1200,0.9,1000,6.8,High,1,6800,6800
Packaged Food,iD Malabar Parota ,8000,10,4,7200,400,FALSE,400,800,1,160000,18,High,0.4,7200,2880000
Packaged Food,iD Wheat Lachha Paratha,8000,12,6,7000,400,FALSE,400,1000,1,160000,17.5,High,0.4,7000,2800000
Packaged Food,McCain Aloo Tikki,11000,4,6,10500,400,FALSE,400,500,1,160000,26.25,High,0.4,10500,4200000
Packaged Food,McCain Smiles Cripsy Happy Potatoes,12000,5,6,11400,415,FALSE,415,600,1,172225,27.47,High,0.415,11400,4731000
Packaged Food,McCain Veggie Burger Patty,11500,3,6,11100,360,FALSE,360,400,1,129600,30.83,High,0.36,11100,3996000
Packaged Food,McCain Veggie Fingers,11700,5,6,11100,400,FALSE,400,600,1,160000,27.75,High,0.4,11100,4440000
Packaged Food,Amul Delicious Fat Spread - Cholesterol Free,1800,5,6,1700,100,FALSE,100,100,0.9,10000,17,Low,0.1,1700,170000
Packaged Food,Whiskas Wet  Meal (Adult - Cat Food)  Chicken in Gravy,3500,2,2,3400,85,FALSE,85,100,1,7225,40,Medium,0.085,3400,289000
Packaged Food,McCain Chilli Garlic Potato Bites Crunchy Potato Nuggets,12500,5,1,11800,420,FALSE,420,700,1,176400,28.1,High,0.42,11800,4956000
Packaged Food,Ching's Secret Instant Hot Garlic Noodles,1500,0,3,1500,60,FALSE,60,0,1,3600,25,Low,0.06,1500,90000
Packaged Food,Veeba Eggless Mayonnaise,7900,11,5,7000,250,FALSE,250,900,1,62500,28,High,0.25,7000,1750000
Packaged Food,Ching's Secret Instant Schezwan Noodles,1500,0,6,1500,60,FALSE,60,0,1,3600,25,Low,0.06,1500,90000
Packaged Food,Veeba Pasta And Pizza Sauce,7500,13,5,6500,280,FALSE,280,1000,1,78400,23.21,High,0.28,6500,1820000
Packaged Food,Top Ramen  Noodles Curry Veg Pouch,2000,0,1,2000,70,FALSE,70,0,1,4900,28.57,Medium,0.07,2000,140000
Packaged Food,Saffola Veggie Twist Masala Oats,1500,0,6,1500,38,FALSE,38,0,1,1444,39.47,Low,0.038,1500,57000
Packaged Food,Unibic Almond & Oats Protein Bar,4000,17,4,3300,30,FALSE,30,700,1,900,110,High,0.03,3300,99000
Packaged Food,Quaker Oats,7900,0,2,7900,400,FALSE,400,0,0.9,160000,19.75,High,0.4,7900,3160000
Packaged Food,Amul Delicious Fat Spread - Cholesterol Free,8800,2,2,8600,500,FALSE,500,200,0.9,250000,17.2,High,0.5,8600,4300000
Packaged Food,McCain French Fries,12000,5,1,11400,420,FALSE,420,600,1,176400,27.14,High,0.42,11400,4788000
Packaged Food,Ching's Secret Manchow Instant Soup,1000,0,1,1000,15,FALSE,15,0,1,225,66.67,Low,0.015,1000,15000
Packaged Food,McCain Potato Cheese Shotz,13000,4,6,12400,250,FALSE,250,600,1,62500,49.6,High,0.25,12400,3100000
Packaged Food,McCain Masala - Fries,12000,5,3,11400,375,FALSE,375,600,1,140625,30.4,High,0.375,11400,4275000
Packaged Food,Ching's Secret Schezwan Fried Rice Masala,1500,0,6,1500,20,FALSE,20,0,1,400,75,Low,0.02,1500,30000
Packaged Food,McCain New Mini Samosa with Cheese Pizza Style Filling,12000,1,3,11800,240,FALSE,240,200,1,57600,49.17,High,0.24,11800,2832000
Packaged Food,McCain Chilli Cheesy Nuggets,13000,4,1,12400,250,FALSE,250,600,1,62500,49.6,High,0.25,12400,3100000
Packaged Food,"Whiskas Adult (+1 Year) Dry Cat Food, Ocean Fish Flavour",43000,10,6,38700,1200,FALSE,1,4300,1,1200,32.25,High,1.2,38700,38700
Packaged Food,Chings Instant Soup - Hot & Sour,1000,0,1,1000,15,FALSE,15,0,1,225,66.67,Low,0.015,1000,15000
Packaged Food,Amul Spray Infant Milk Food,19700,2,6,19300,500,FALSE,500,400,1,250000,38.6,High,0.5,19300,9650000
Packaged Food,McCain Smiles - Pudina Chatka,12000,5,3,11400,375,FALSE,375,600,1,140625,30.4,High,0.375,11400,4275000
Packaged Food,McCain French Fries Crisp & Delicious,17500,4,3,16700,750,FALSE,750,800,1,562500,22.27,High,0.75,16700,12525000
Packaged Food,Ferrero Nutella Hazelnut Spread,22000,5,2,20700,180,FALSE,180,1300,1,32400,115,High,0.18,20700,3726000
Packaged Food,Lijjat Garlic Papad,6000,5,5,5700,200,FALSE,200,300,1,40000,28.5,High,0.2,5700,1140000
Packaged Food,Switz Samosa Dough Sheets,9000,4,6,8600,50,FALSE,50,400,1,2500,172,High,0.05,8600,430000
Packaged Food,Amul Cheese Spread Creamy,8500,5,6,8000,180,FALSE,180,500,1,32400,44.44,High,0.18,8000,1440000
Packaged Food,Maggi Imli Sauce Pichkoo,2200,0,6,2200,90,FALSE,90,0,1,8100,24.44,Medium,0.09,2200,198000
Packaged Food,Whiskas Kitten (2-12 months) Dry Cat Food Food Ocean Fish,38500,9,5,34700,1100,FALSE,1100,3800,1,1210000,31.55,High,1.1,34700,38170000
Packaged Food,Chings Instant Soup - Sweet Corn Veg,1000,0,2,1000,15,FALSE,15,0,1,225,66.67,Low,0.015,1000,15000
Packaged Food,Whiskas Wet  Meal (Kitten - Cat Food)  Chicken in Gravy,3500,5,2,3300,85,FALSE,85,200,1,7225,38.82,Medium,0.085,3300,280500
Packaged Food,McCain Crazy Fries Masala MixHot 'n' Tangy,12000,5,6,11400,400,FALSE,400,600,1,160000,28.5,High,0.4,11400,4560000
Packaged Food,The Whole Truth Double Cocoa Protein Bar No Sugar,10000,10,6,9000,52,FALSE,52,1000,1,2704,173.08,High,0.052,9000,468000
Packaged Food,Amul Happy Treats French Fries,6800,4,1,6500,425,FALSE,425,300,0.9,180625,15.29,High,0.425,6500,2762500
Packaged Food,Ferrero Nutella Hazeulnut Spread,38000,6,5,35700,350,FALSE,350,2300,1,122500,102,High,0.35,35700,12495000
Packaged Food,Veeba Chipolte Southwest Dressing,16100,7,4,14900,300,FALSE,300,1200,1,90000,49.67,High,0.3,14900,4470000
Packaged Food,Ching's Secret Manchow Noodles Instant Soup,1500,0,6,1500,20,FALSE,20,0,1,400,75,Low,0.02,1500,30000
Packaged Food,Yoga Bar Breakfast Protein Bar - Blueberry Pie,5000,12,1,4400,50,FALSE,50,600,1,2500,88,High,0.05,4400,220000
Packaged Food,Quaker Oats,19900,7,6,18400,1000,FALSE,1,1500,0.9,1000,18.4,High,1,18400,18400
Packaged Food,The Whole Truth Mini Protein Bar - Coconut Cocoa No Added Sugar,5500,25,6,4100,27,FALSE,27,1400,1,729,151.85,High,0.027,4100,110700
Packaged Food,Switz Spring Roll Dough Sheets,9000,4,6,8600,1160,FALSE,20,400,0.9,23200,7.41,High,1.16,8600,172000
Packaged Food,Unibic Fruit & Nut Real Cranberries & Almonds Protein Bar,4000,17,6,3300,30,FALSE,30,700,1,900,110,High,0.03,3300,99000
Packaged Food,Ching's Secret Tomato Instant Soup,1000,0,1,1000,16,FALSE,15,0,1,240,62.5,Low,0.016,1000,15000
Packaged Food,Chef's Basket Durum Wheat Elbow Pasta,16000,50,6,8000,500,FALSE,500,8000,1,250000,16,High,0.5,8000,4000000
Packaged Food,Sunfeast Yippee! Mood Masala Noodles,6000,28,3,4300,260,FALSE,260,1700,1,67600,16.54,High,0.26,4300,1118000
Packaged Food,MTR Breakfast Khatta Meetha Poha Mix,2500,20,6,2000,60,FALSE,60,500,1,3600,33.33,Medium,0.06,2000,120000
Packaged Food,Kellogg's Crunchy Fruit & Nut Breakfast Cereals Muesli,44500,9,6,40100,750,FALSE,750,4400,1,562500,53.47,High,0.75,40100,30075000
Packaged Food,Ching's Secret Chilli Vinegar,5000,0,4,5000,170,FALSE,170,0,1,28900,29.41,High,0.17,5000,850000
Packaged Food,Ching's Red Chilli Sauce,5500,0,6,5500,200,FALSE,200,0,1,40000,27.5,High,0.2,5500,1100000
Packaged Food,Amul Lite Spread,4000,2,5,3900,100,FALSE,100,100,1,10000,39,High,0.1,3900,390000
Packaged Food,Borges Durum Wheat Fusilli Pasta ,25000,0,3,25000,500,FALSE,500,0,1,250000,50,High,0.5,25000,12500000
Packaged Food,The Whole Truth Cranberry Mini Protein Bar No Sugar,5500,20,6,4400,27,FALSE,27,1100,1,729,162.96,High,0.027,4400,118800
Packaged Food,The Whole Truth Mini Protein Bar - Coffee Cocoa No Added Sugar,5500,20,6,4400,27,FALSE,27,1100,1,729,162.96,High,0.027,4400,118800
Packaged Food,Maggi Hot & Sweet Tomato Chilli Sauce,11500,0,1,11500,500,FALSE,500,0,1,250000,23,High,0.5,11500,5750000
Packaged Food,Sunfeast YiPPee! Noodles - Magic Masala,9600,5,4,9100,540,FALSE,540,500,0.9,291600,16.85,High,0.54,9100,4914000
Packaged Food,Chef's Basket Durum Wheat Fusilli Pasta,16000,50,6,8000,500,FALSE,500,8000,1,250000,16,High,0.5,8000,4000000
Packaged Food,Top Ramen Chicken Noodles,6000,10,1,5400,280,FALSE,280,600,1,78400,19.29,High,0.28,5400,1512000
Packaged Food,Veeba Cheese and Chilli Sandwich Spread,8900,11,6,7900,275,FALSE,275,1000,1,75625,28.73,High,0.275,7900,2172500
Packaged Food,Chings Secret Chowmein Hakka Noodles Masala ,4400,0,2,4400,60,FALSE,60,0,1,3600,73.33,High,0.06,4400,264000
Packaged Food,Safal Frozen - Mixed Vegetables,11000,4,2,10500,1000,FALSE,1,500,0.9,1000,10.5,High,1,10500,10500
Packaged Food,MTR 3 Min Poha,2500,0,6,2500,60,FALSE,60,0,1,3600,41.67,Medium,0.06,2500,150000
Packaged Food,Ching's Manchurian Instant Noodles,1500,0,5,1500,60,FALSE,60,0,1,3600,25,Low,0.06,1500,90000
Packaged Food,The Whole Truth Peanut Cocoa Mini Protein Bar No Sugar ,5500,25,6,4100,27,FALSE,27,1400,1,729,151.85,High,0.027,4100,110700
Packaged Food,Gits Pav Bhaji Ready to Eat,11000,22,6,8500,300,FALSE,300,2500,1,90000,28.33,High,0.3,8500,2550000
Packaged Food,McCain New Mini Samosa with Cheese Corn Style Filling,12000,1,2,11800,240,FALSE,240,200,1,57600,49.17,High,0.24,11800,2832000
Packaged Food,Lijjat Udad Mini Papad,6000,6,6,5600,200,FALSE,200,400,1,40000,28,High,0.2,5600,1120000
Packaged Food,McCain Herb & Garlic Crazy Fries Masala Mix ,12000,5,5,11400,400,FALSE,400,600,1,160000,28.5,High,0.4,11400,4560000
Packaged Food,Yoga Bar Multigrain Energy Bar Nuts And Seeds,4000,12,4,3500,38,FALSE,38,500,1,1444,92.11,High,0.038,3500,133000
Packaged Food,"Ching's Secret Sauce, Green Chilli",5500,0,5,5500,190,FALSE,190,0,1,36100,28.95,High,0.19,5500,1045000
Packaged Food,Veeba Pizza Topping,7500,6,4,7000,280,FALSE,280,500,1,78400,25,High,0.28,7000,1960000
Packaged Food,Switz Paratha Puff,11000,4,6,10500,400,FALSE,400,500,1,160000,26.25,High,0.4,10500,4200000
Packaged Food,"New Kellogg's Muesli with 21% Fruit, Nut & Seeds",32500,6,6,30500,500,FALSE,500,2000,1,250000,61,High,0.5,30500,15250000
Packaged Food,The Whole Truth Double Cocoa Mini Protein Bar No Sugar,5500,20,5,4400,27,FALSE,27,1100,1,729,162.96,High,0.027,4400,118800
Packaged Food,Sunfeast Yippee Tricolor Pasta Seasoning,2800,17,1,2300,65,FALSE,65,500,1,4225,35.38,Medium,0.065,2300,149500
Packaged Food,Wingreens Cheesy Chipotle Sauce,9900,49,1,5000,130,FALSE,130,4900,1,16900,38.46,High,0.13,5000,650000
Packaged Food,Maggi Rich Tomato Ketchup,10500,4,2,10000,500,FALSE,500,500,1,250000,20,High,0.5,10000,5000000
Packaged Food,The Whole Truth Dark Chocolate Peanut Butter - Creamy,23500,25,6,17400,325,FALSE,325,6100,1,105625,53.54,High,0.325,17400,5655000
Packaged Food,Godrej Yummiez Chicken Nuggets,32500,9,1,29300,500,FALSE,500,3200,1,250000,58.6,High,0.5,29300,14650000
Packaged Food,Go Cheese  Spread Plain,9900,5,6,9400,200,FALSE,200,500,1,40000,47,High,0.2,9400,1880000
Packaged Food,Kellogg's Real Almond & Honey Corn Flakes,17500,9,6,15800,300,FALSE,300,1700,1,90000,52.67,High,0.3,15800,4740000
Packaged Food,The Whole Truth Vegan Almond Choco Fudge Energy Bar No Sugar,6000,20,6,4800,40,FALSE,40,1200,1,1600,120,High,0.04,4800,192000
Packaged Food,Prasuma Vegetable Momos,27000,0,5,27000,24,FALSE,24,0,1,576,1125,High,0.024,27000,648000
Packaged Food,MTR Upma,5000,10,6,4500,160,FALSE,160,500,1,25600,28.13,High,0.16,4500,720000
Packaged Food,Ching's Schezwan Masala Instant Noodles,6000,0,1,6000,240,FALSE,240,0,1,57600,25,High,0.24,6000,1440000
Packaged Food,The Whole Truth Cranberry Protein Bar No Sugar,10000,26,6,7400,52,FALSE,52,2600,1,2704,142.31,High,0.052,7400,384800
Packaged Food,Saffola Yummy Masala Noodles ,2000,0,2,2000,46,FALSE,46,0,1,2116,43.48,Medium,0.046,2000,92000
Packaged Food,Veeba English Mustard,7400,6,2,6900,300,FALSE,300,500,1,90000,23,High,0.3,6900,2070000
Packaged Food,Dabur Hommade Tamarind Paste,4800,6,6,4500,200,FALSE,200,300,1,40000,22.5,High,0.2,4500,900000
Packaged Food,Yoga Bar Breakfast Muesli - Almond Caramel (No Added Sugar),32500,4,6,30900,400,FALSE,400,1600,1,160000,77.25,High,0.4,30900,12360000
Packaged Food,The Whole Truth Mini Protein Bar - Peanut Butter No Added Sugar,5500,25,6,4100,27,FALSE,27,1400,1,729,151.85,High,0.027,4100,110700
Packaged Food,ITC Master Chef Crispy Chicken Fries ,17000,4,3,16200,280,FALSE,280,800,1,78400,57.86,High,0.28,16200,4536000
Packaged Food,Kelloggs Corn Flakes,9900,13,6,8600,250,FALSE,250,1300,1,62500,34.4,High,0.25,8600,2150000
Packaged Food,Nissin Cup Noodles Tangy Tomato,5000,10,2,4500,70,FALSE,70,500,1,4900,64.29,High,0.07,4500,315000
Packaged Food,Smith & Jones White Pasta Sauce Mix,4000,0,3,4000,46,FALSE,46,0,1,2116,86.96,High,0.046,4000,184000
Packaged Food,Sunfeast Yippee! Pasta Treat - Sour Cream Onion,2800,10,1,2500,65,FALSE,65,300,1,4225,38.46,Medium,0.065,2500,162500
Packaged Food,Mothers Recipe Tamrind Date Chutney ,5500,9,2,5000,200,FALSE,200,500,1,40000,25,High,0.2,5000,1000000
Packaged Food,Veeba Mint Mayonnaise,16900,8,4,15500,300,FALSE,300,1400,1,90000,51.67,High,0.3,15500,4650000
Packaged Food,Mccain Emotibites - Crispy Happy Potato Snack,13000,0,6,12900,415,FALSE,415,100,1,172225,31.08,High,0.415,12900,5353500
Packaged Food,The Whole Truth Energy Bar Choco Cranberry Fudge,6000,26,6,4400,40,FALSE,40,1600,1,1600,110,High,0.04,4400,176000
Packaged Food,Godrej Yummiez Chicken Lucknowi Seekh Kebab,26000,10,4,23400,400,FALSE,400,2600,1,160000,58.5,High,0.4,23400,9360000
Packaged Food,Prasuma Vegetable Momos,15000,0,5,15000,580,FALSE,10,0,1,5800,25.86,High,0.58,15000,150000
Packaged Food,Mother's Recipe Mixed Pickle,8500,9,2,7700,300,FALSE,300,800,1,90000,25.67,High,0.3,7700,2310000
Packaged Food,Sunfeast Yippee! Pasta Treat - Sour Cream Onion,2800,17,3,2300,65,FALSE,65,500,1,4225,35.38,Medium,0.065,2300,149500
Packaged Food,The Whole Truth Peanut Cocoa Protein Bar No Sugar,10000,26,6,7400,52,FALSE,52,2600,1,2704,142.31,High,0.052,7400,384800
Packaged Food,Yoga Bar Breakfast Muesli - Chocolate & Cranberry ,32500,4,6,30900,400,FALSE,400,1600,1,160000,77.25,High,0.4,30900,12360000
Packaged Food,Sunfeast YiPPee! Magic Masala Noodles,7000,10,3,6300,405,FALSE,405,700,0.9,164025,15.56,High,0.405,6300,2551500
Packaged Food,Veeba Sweet Onion Sauce,14100,14,4,12100,350,FALSE,350,2000,1,122500,34.57,High,0.35,12100,4235000
Packaged Food,Quaker Oats Breakfast Cereals - With Flavour Mix Nutritious Rich Source Of Energy,4900,8,6,4500,200,FALSE,200,400,1,40000,22.5,High,0.2,4500,900000
Packaged Food,Mother's Recipe Tamarind Paste,5000,2,6,4900,200,FALSE,200,100,1,40000,24.5,High,0.2,4900,980000
Packaged Food,Yogabar No Added Sugar Protein Bar Brownie,12500,15,4,10600,60,FALSE,60,1900,1,3600,176.67,High,0.06,10600,636000
Packaged Food,Bambino Popular Vermicelli ,4000,2,3,3900,400,FALSE,400,100,0.9,160000,9.75,High,0.4,3900,1560000
Packaged Food,Ching's Secret Mix Veg Instant Soup,1000,0,3,1000,15,FALSE,15,0,1,225,66.67,Low,0.015,1000,15000
Packaged Food,Mother's Recipe Pickle - Red Stuffed Chilli,14500,11,3,12900,400,FALSE,400,1600,1,160000,32.25,High,0.4,12900,5160000
Packaged Food,Kellogg's No Added Sugar Muesli,33500,11,6,29800,500,FALSE,500,3700,1,250000,59.6,High,0.5,29800,14900000
Packaged Food,Veeba Salsa Dip,11900,6,6,11100,360,FALSE,360,800,1,129600,30.83,High,0.36,11100,3996000
Packaged Food,Veeba Thousand Island Dressing,14900,8,6,13700,300,FALSE,300,1200,1,90000,45.67,High,0.3,13700,4110000
Packaged Food,Baggry's Crunchy Muesli Almond Raisins & Honey,13000,0,5,13000,200,FALSE,200,0,1,40000,65,High,0.2,13000,2600000
Packaged Food,Knorr Chinese Hot And Sour Veg Soup,5500,3,1,5300,43,FALSE,43,200,1,1849,123.26,High,0.043,5300,227900
Packaged Food,Go Cheese Spread - Garlic,9900,5,6,9400,200,FALSE,200,500,1,40000,47,High,0.2,9400,1880000
Packaged Food,The Whole Truth Peanut Butter With Dates - Creamy No Sugar,21500,9,6,19400,325,FALSE,325,2100,1,105625,59.69,High,0.325,19400,6305000
Packaged Food,Zorabian Chicken Smoked Ham,20500,5,1,19400,250,FALSE,250,1100,1,62500,77.6,High,0.25,19400,4850000
Packaged Food,Kissan Pineapple Jam,16500,9,1,14900,500,FALSE,500,1600,1,250000,29.8,High,0.5,14900,7450000
Packaged Food,Smith & Jones Masala Noodles,8900,0,5,8900,480,FALSE,480,0,0.9,230400,18.54,High,0.48,8900,4272000
Packaged Food,Nestle Nestle Nan Pro Follow-Up Formula,65000,0,6,65000,400,FALSE,400,0,1,160000,162.5,High,0.4,65000,26000000
Packaged Food,Sunfeast Yippee! Power Up Atta Noodles,9600,15,6,8100,280,FALSE,280,1500,1,78400,28.93,High,0.28,8100,2268000
Packaged Food,McCain Super Wedges,12000,7,6,11100,400,FALSE,400,900,1,160000,27.75,High,0.4,11100,4440000
Packaged Food,"Kellogg's Crunchy Granola Honey, Almonds, Strawberries & Pumpkin Seeds",33000,10,1,29400,450,FALSE,450,3600,1,202500,65.33,High,0.45,29400,13230000
Packaged Food,Kellogg's Chocos,13000,10,6,11700,250,FALSE,250,1300,1,62500,46.8,High,0.25,11700,2925000
Packaged Food,Ching's Secret Just Soak - Whole Wheat Veg Hakka Noodle,3200,0,3,3200,150,FALSE,150,0,1,22500,21.33,Medium,0.15,3200,480000
Packaged Food,The Whole Truth Vegan Fig Apricot & Orange Energy Bar No Sugar,6000,20,6,4800,40,FALSE,40,1200,1,1600,120,High,0.04,4800,192000
Packaged Food,Saffola Veggie Twist Masala Oats,19500,12,2,17100,500,FALSE,500,2400,1,250000,34.2,High,0.5,17100,8550000
Packaged Food,ITC Master Chef Classic Aloo Tikki,8000,10,3,7200,320,FALSE,320,800,1,102400,22.5,High,0.32,7200,2304000
Packaged Food,Smith & Jones Pink Pasta Sauce Mix,4000,0,4,4000,46,FALSE,46,0,1,2116,86.96,High,0.046,4000,184000
Packaged Food,Wingreens Farms Chipotle Dip,20000,25,1,15000,180,FALSE,180,5000,1,32400,83.33,High,0.18,15000,2700000
Packaged Food,Kellogg's Real Almond & Honey Corn Flakes,55000,5,3,52000,1000,FALSE,1,3000,1,1000,52,High,1,52000,52000
Packaged Food,Kellogg's Crunchy Granola Chocolate & Almonds,33000,10,3,29400,450,FALSE,450,3600,1,202500,65.33,High,0.45,29400,13230000
Packaged Food,Cornitos Cornitos Taco Shells - 6 Inches,16000,20,4,12800,180,FALSE,180,3200,1,32400,71.11,High,0.18,12800,2304000
Packaged Food,Ching's Secret Singapore Curry Instant Noodles,1500,0,3,1500,60,FALSE,60,0,1,3600,25,Low,0.06,1500,90000
Packaged Food,Mother's Recipe Pickle - Mango,12500,9,6,11300,400,FALSE,500,1200,1,200000,28.25,High,0.4,11300,5650000
Packaged Food,Godrej Yummiez Chilli Chicken Sausages ,16000,10,3,14400,250,FALSE,250,1600,1,62500,57.6,High,0.25,14400,3600000
Packaged Food,Pedigree Dentastix  Dog Treat Oral Care for Adult Medium Breed ,17500,20,6,14000,180,FALSE,180,3500,1,32400,77.78,High,0.18,14000,2520000
Packaged Food,Maggi Hot & Sweet - Tomato Chilli Sauce,17000,10,1,15300,1000,FALSE,1,1700,0.9,1000,15.3,High,1,15300,15300
Packaged Food,Ching's Secret Asian Hot Instant Soup,1500,0,3,1500,15,FALSE,15,0,1,225,100,Low,0.015,1500,22500
Packaged Food,Kelloggs Chocos Protein And Fibre Of 1 Roti,49900,11,6,44400,1200,FALSE,1,5500,1,1200,37,High,1.2,44400,44400
Packaged Food,Mother's Recipe Pickle - Mango,14900,26,4,10900,500,FALSE,500,4000,1,250000,21.8,High,0.5,10900,5450000
Packaged Food,Chings Secret Manchurian Instant Noodle,6000,0,6,6000,240,FALSE,240,0,1,57600,25,High,0.24,6000,1440000
Packaged Food,Kellogg's Original Corn Flakes,31000,6,6,29000,875,FALSE,875,2000,1,765625,33.14,High,0.875,29000,25375000
Packaged Food,Ching's Singapore Curry Instant Noodles,6000,0,4,6000,240,FALSE,240,0,1,57600,25,High,0.24,6000,1440000
Packaged Food,Kellogg's Almonds And Cranberries Granola,33000,6,6,31000,460,FALSE,460,2000,1,211600,67.39,High,0.46,31000,14260000
Packaged Food,Nestle Ceregrow Multigrain Cereal with Milk and Fruits - 3 to 6 years,29200,0,6,29200,300,FALSE,300,0,1,90000,97.33,High,0.3,29200,8760000
Packaged Food,MTR 3 Minute Breakfast - Magic Masala Upma,2500,0,6,2500,60,FALSE,60,0,1,3600,41.67,Medium,0.06,2500,150000
Packaged Food,Smith & Jones Masala Noodles,6800,10,5,6100,360,FALSE,360,700,0.9,129600,16.94,High,0.36,6100,2196000
Packaged Food,"Knorr Classic Tomato Soup With 100% Real Vegetabls, No Added Preservatives",5500,0,6,5500,53,FALSE,53,0,1,2809,103.77,High,0.053,5500,291500
Packaged Food,Godrej Yummiez Chicken Punjabi Tikka ,29500,9,6,26600,360,FALSE,360,2900,1,129600,73.89,High,0.36,26600,9576000
Packaged Food,Kellogg's Corn Flakes,42500,9,1,38300,1000,FALSE,1,4200,1,1000,38.3,High,1,38300,38300
Packaged Food,Kelloggs Chocos,17000,5,4,16000,385,FALSE,385,1000,1,148225,41.56,High,0.385,16000,6160000
Packaged Food,Pedigree Puppy Dry Dog Food Food Chicken & Milk,29000,20,6,23200,1200,FALSE,1200,5800,1,1440000,19.33,High,1.2,23200,27840000
Packaged Food,Ching's Secret Lemon Coriander Instant Soup,1500,0,5,1500,15,FALSE,15,0,1,225,100,Low,0.015,1500,22500
Packaged Food,Nestle Cerelac Baby Cereal With Milk Wheat-Rice Mixed Fruit,26100,0,6,26100,300,FALSE,300,0,1,90000,87,High,0.3,26100,7830000
Packaged Food,Kelloggs Chocos - Moons & Stars,66000,40,4,39600,1200,FALSE,1,26400,1,1200,33,High,1.2,39600,39600
Packaged Food,ITC Master Chef Chicken Galouti Kebab,17000,4,2,16200,210,FALSE,210,800,1,44100,77.14,High,0.21,16200,3402000
Packaged Food,Yogabar 100% Pure Peanut Butter Creamy & Yummy Unsweetened,22900,10,6,20600,400,FALSE,400,2300,1,160000,51.5,High,0.4,20600,8240000
Packaged Food,Kitchens Of India Palak Paneer,13000,30,6,9100,285,FALSE,285,3900,1,81225,31.93,High,0.285,9100,2593500
Packaged Food,Kelloggs Chocos Fills Double Chocolat,9900,11,6,8800,175,FALSE,175,1100,1,30625,50.29,High,0.175,8800,1540000
Packaged Food,Soulfull Ragi Bites Choco Fills,16900,5,4,16000,250,FALSE,250,900,1,62500,64,High,0.25,16000,4000000
Packaged Food,Figaro Sliced Black Olive ,17900,0,6,17900,450,FALSE,450,0,1,202500,39.78,High,0.45,17900,8055000
Packaged Food,Veeba Barbeque Sauce,14900,8,6,13700,330,FALSE,330,1200,1,108900,41.52,High,0.33,13700,4521000
Packaged Food,The Whole Truth Vegan Mocha Almond Fudge Energy Bar No Sugar,6000,20,6,4800,40,FALSE,40,1200,1,1600,120,High,0.04,4800,192000
Packaged Food,"The Whole Truth - Nuts, Fruits & Seeds Muesli",32500,20,6,26000,350,FALSE,350,6500,1,122500,74.29,High,0.35,26000,9100000
Packaged Food,Pantai Green Curry Paste,15000,14,5,12800,114,FALSE,114,2200,1,12996,112.28,High,0.114,12800,1459200
Packaged Food,Kelloggs Special K,21000,8,5,19200,435,FALSE,435,1800,1,189225,44.14,High,0.435,19200,8352000
Packaged Food,Moi Soi Sichuan Chilli Oil- For Stir Fry Marinade Spread & Dip,28000,50,5,14000,175,FALSE,175,14000,1,30625,80,High,0.175,14000,2450000
Packaged Food,Mother's Recipe Madras Appalam,5000,10,6,4500,100,FALSE,100,500,1,10000,45,High,0.1,4500,450000
Packaged Food,Top Ramen Masala Oat Masala,8000,10,6,7200,280,FALSE,280,800,1,78400,25.71,High,0.28,7200,2016000
Packaged Food,Saffola Everyday Peppy Tomato Masala Oats,19500,12,6,17100,500,FALSE,500,2400,1,250000,34.2,High,0.5,17100,8550000
Packaged Food,"Ching's Secret Instant Noodles, Hot Garlic",6000,0,4,6000,240,FALSE,240,0,1,57600,25,High,0.24,6000,1440000
Packaged Food,Kitchens Of India Chicken Chettinad,20000,30,1,14000,285,FALSE,285,6000,1,81225,49.12,High,0.285,14000,3990000
Packaged Food,Nestle Cerelac Wheat - Stage 1,19000,0,6,19000,300,FALSE,300,0,1,90000,63.33,High,0.3,19000,5700000
Packaged Food,Sumeru Aloo Paratha,11900,5,6,11300,400,FALSE,400,600,1,160000,28.25,High,0.4,11300,4520000
Packaged Food,ITC Master Chef Veggie Pizza Pocket,17000,4,4,16200,340,FALSE,340,800,1,115600,47.65,High,0.34,16200,5508000
Packaged Food,Wingreens Farms Tangy Cheese Pita Chips & Mexican Salsa Dip,6000,15,1,5100,70,FALSE,70,900,1,4900,72.86,High,0.07,5100,357000
Packaged Food,Ching's Secret Manchow Soup,5500,0,3,5500,55,FALSE,55,0,1,3025,100,High,0.055,5500,302500
Packaged Food,Veeba Carrot & Cucumber Sandwich Spread,8500,10,6,7600,250,FALSE,250,900,1,62500,30.4,High,0.25,7600,1900000
Packaged Food,Kellogg's Real Almond & Honey Corn Flakes,37000,12,3,32400,650,FALSE,650,4600,1,422500,49.85,High,0.65,32400,21060000
Packaged Food,Kitchens Of India Mughlai Paneer,16000,30,4,11200,285,FALSE,285,4800,1,81225,39.3,High,0.285,11200,3192000
Packaged Food,Ching's Secret Just Soak - Veg Hakka Noodles,3000,0,5,3000,150,FALSE,150,0,1,22500,20,Medium,0.15,3000,450000
Packaged Food,Ching's Secret Chowmein Hakka Noodles Masala,6000,10,2,5400,100,FALSE,100,600,1,10000,54,High,0.1,5400,540000
Packaged Food,The Whole Truth Dark Chocolate Peanut Butter - Crunchy,23500,20,5,18800,325,FALSE,325,4700,1,105625,57.85,High,0.325,18800,6110000
Packaged Food,Mother's Recipe Bhel Puri Chutney,5500,9,4,5000,200,FALSE,200,500,1,40000,25,High,0.2,5000,1000000
Packaged Food,Kelloggs Chocos Moon & Stars,33000,10,6,29400,680,FALSE,680,3600,1,462400,43.24,High,0.68,29400,19992000
Packaged Food,Mother's Recipe Lime Pickle ,12000,5,1,11400,400,FALSE,400,600,1,160000,28.5,High,0.4,11400,4560000
Packaged Food,Kitchens of India Dal Makhani,11000,30,2,7700,285,FALSE,285,3300,1,81225,27.02,High,0.285,7700,2194500
Packaged Food,Pantai Light Soy Sauce,27500,14,5,23400,200,FALSE,200,4100,1,40000,117,High,0.2,23400,4680000
Packaged Food,Ching's Secret Sweet Corn Soup,5500,0,6,5500,55,FALSE,55,0,1,3025,100,High,0.055,5500,302500
Packaged Food,"Top Ramen Noodles, Atta",8000,0,1,8000,280,FALSE,280,0,1,78400,28.57,High,0.28,8000,2240000
Packaged Food,Cantina Tortilla Dip Sauce Sour Creamy Tex Mex,22500,15,5,19100,190,FALSE,190,3400,1,36100,100.53,High,0.19,19100,3629000
Packaged Food,Dabur Hommade - Rajasthan Ki Garlic Chutne,6500,6,6,6100,200,FALSE,200,400,1,40000,30.5,High,0.2,6100,1220000
Packaged Food,MTR Seviyan Vermicelli ,4200,0,2,4200,400,FALSE,400,0,0.9,160000,10.5,High,0.4,4200,1680000
Packaged Food,Pantai Oyster Sauce,27500,14,4,23400,200,FALSE,200,4100,1,40000,117,High,0.2,23400,4680000
Packaged Food,Go Cheese Spread - Four Pepper (Soft & Creamy),9900,5,6,9400,200,FALSE,200,500,1,40000,47,High,0.2,9400,1880000
Packaged Food,MTR Ready To Eat Paneer Butter Masala,13500,9,2,12200,300,FALSE,300,1300,1,90000,40.67,High,0.3,12200,3660000
Packaged Food,Nestle Lactogen Stage 2 Follow-up Formula Powder,34000,0,2,34000,400,FALSE,400,0,1,160000,85,High,0.4,34000,13600000
Packaged Food,Kellogg's Crunchy Bites Chocos,19000,10,6,17100,375,FALSE,375,1900,1,140625,45.6,High,0.375,17100,6412500
Packaged Food,Veeba Hot Sweet Tomato Chilli Sauce,10400,20,3,8300,500,FALSE,500,2100,1,250000,16.6,High,0.5,8300,4150000
Packaged Food,Borges Durum Wheat Pasta Superior Quality,25000,40,6,14900,500,FALSE,500,10100,1,250000,29.8,High,0.5,14900,7450000
Packaged Food,Funfoods Peanut Butter Crunchy,16900,7,1,15600,400,FALSE,400,1300,1,160000,39,High,0.4,15600,6240000
Packaged Food,Pantai Red Curry Paste,6000,0,4,6000,50,FALSE,50,0,1,2500,120,High,0.05,6000,300000
Packaged Food,ITC Master Chef Chicken Seekh Kabab,32500,0,6,32500,500,FALSE,500,0,1,250000,65,High,0.5,32500,16250000
Packaged Food,Del Monte Pizza & Pasta Sauce Spout Pack,9900,0,3,9900,400,FALSE,400,0,1,160000,24.75,High,0.4,9900,3960000
Packaged Food,Pantai Sriracha Red Chilli Sauce,22500,15,6,19100,200,FALSE,200,3400,1,40000,95.5,High,0.2,19100,3820000
Packaged Food,Hershey's Cocoa Spread,29500,0,3,29500,350,FALSE,350,0,1,122500,84.29,High,0.35,29500,10325000
Packaged Food,Maggi Ghee Tadka Upma Express Pouch,2500,0,6,2500,65,FALSE,65,0,1,4225,38.46,Medium,0.065,2500,162500
Packaged Food,Ching's Secret Manchurian Noodles,9100,0,5,9100,360,FALSE,360,0,1,129600,25.28,High,0.36,9100,3276000
Packaged Food,Kellogg's All Bran Wheat Flakes,22000,6,5,20500,425,FALSE,425,1500,1,180625,48.24,High,0.425,20500,8712500
Packaged Food,Yummiez Chicken Breakfast Sausages,15000,0,3,15000,250,FALSE,250,0,1,62500,60,High,0.25,15000,3750000
Packaged Food,Pantai Red Curry Paste,15000,14,3,12800,114,FALSE,114,2200,1,12996,112.28,High,0.114,12800,1459200
Packaged Food,Bagrrys Muesli Crunchy Fruit & Nut With Cranberries,33000,10,6,29700,400,FALSE,400,3300,1,160000,74.25,High,0.4,29700,11880000
Packaged Food,Quaker Oats Pouch,27600,10,6,24800,1500,FALSE,1,2800,0.9,1500,16.53,High,1.5,24800,24800
Packaged Food,Prasuma Momos -  Cheesy Spicy Veg,29500,0,6,29500,24,FALSE,24,0,1,576,1229.17,High,0.024,29500,708000
Packaged Food,Veeba Sriracha Chilli Garlic Sauce,14900,8,5,13700,320,FALSE,320,1200,1,102400,42.81,High,0.32,13700,4384000
Packaged Food,Ching's Secret Just Soak - Veg Hakka Noodles,11500,0,6,11500,600,FALSE,600,0,0.9,360000,19.17,High,0.6,11500,6900000
Packaged Food,Moi Soi Kung Pao Sauce - For Stir Fry Marinade Spread & Dip,28000,50,5,14000,175,FALSE,175,14000,1,30625,80,High,0.175,14000,2450000
Packaged Food,Figaro Plain Green Olive ,17900,0,6,17900,450,FALSE,450,0,1,202500,39.78,High,0.45,17900,8055000
Packaged Food,Mother's Recipe Gujrati Gorkeri Pickle,14000,10,3,12600,500,FALSE,500,1400,1,250000,25.2,High,0.5,12600,6300000
Packaged Food,Kellogg's Muesli 20% Nuts Delight,32000,0,6,32000,500,FALSE,500,0,1,250000,64,High,0.5,32000,16000000
Packaged Food,Borges Farfalle Durum Wheat Pasta ,25000,0,5,25000,500,FALSE,500,0,1,250000,50,High,0.5,25000,12500000
Packaged Food,Kellogg's Chocos,29900,10,4,26900,700,FALSE,700,3000,1,490000,38.43,High,0.7,26900,18830000
Packaged Food,Nestle Nan Pro 4 Follow Up Formula Powder For Older Infants ,62000,0,1,62000,400,FALSE,400,0,1,160000,155,High,0.4,62000,24800000
Packaged Food,Veeba Truly Tomato Ketchup,9900,20,6,7900,500,FALSE,500,2000,0.9,250000,15.8,High,0.5,7900,3950000
Packaged Food,Ching's Secret Green Chilli Sauce,8500,4,1,8100,680,FALSE,680,400,0.9,462400,11.91,High,0.68,8100,5508000
Packaged Food,MTR Roasted Vermicelli ,5500,0,1,5500,400,FALSE,400,0,0.9,160000,13.75,High,0.4,5500,2200000
Packaged Food,Mother's Recipe Punjabi Teekha Mang Pickle,12000,10,4,10800,400,FALSE,400,1200,1,160000,27,High,0.4,10800,4320000
Packaged Food,Ching's Secret Hot Garlic Instant Noodles,11400,0,6,11400,480,FALSE,480,0,1,230400,23.75,High,0.48,11400,5472000
Packaged Food,Kellogg's Real Honey Corn Flakes,29000,7,5,26700,630,FALSE,630,2300,1,396900,42.38,High,0.63,26700,16821000
Packaged Food,ITC Master Chef Lebanese Falafel Kebab,13000,4,4,12400,230,FALSE,230,600,1,52900,53.91,High,0.23,12400,2852000
Packaged Food,Kelloggs Chocos Fills Double Chocolaty,18500,10,5,16500,250,FALSE,250,2000,1,62500,66,High,0.25,16500,4125000
Packaged Food,Organic India Apple Cider Vinegar,59500,9,2,53600,500,FALSE,500,5900,1,250000,107.2,High,0.5,53600,26800000
Packaged Food,Masala Oats Masala & Coriander ,19500,9,5,17600,500,FALSE,500,1900,1,250000,35.2,High,0.5,17600,8800000
Packaged Food,Ching's Secret  Noodles - Pad Thai Lemongras,20000,0,5,20000,130,FALSE,130,0,1,16900,153.85,High,0.13,20000,2600000
Packaged Food,Bagrrys Fruit and Nut Muesli with Cranberries,49900,0,5,49900,750,FALSE,750,0,1,562500,66.53,High,0.75,49900,37425000
Packaged Food,Kitchens Of India Yellow Dal Tadka,11000,30,6,7700,285,FALSE,285,3300,1,81225,27.02,High,0.285,7700,2194500
Packaged Food,Soulfull Vanilla Fills - Ragi Bites,16900,5,6,16000,250,FALSE,250,900,1,62500,64,High,0.25,16000,4000000
Packaged Food,Pantai Teriyaki Sauce with Garlic,32500,15,6,27600,200,FALSE,200,4900,1,40000,138,High,0.2,27600,5520000
Packaged Food,Whiskas Adult Pocket Tuna Cat Food,41000,0,1,41000,1200,FALSE,1,0,1,1200,34.17,High,1.2,41000,41000
Packaged Food,Kitchens Of India Chicken Darbari ,20000,30,4,14000,285,FALSE,285,6000,1,81225,49.12,High,0.285,14000,3990000
Packaged Food,Soulfull Millet Muesli Fruit & Nut Almonds & Real Fruits,29900,10,6,26900,400,FALSE,400,3000,1,160000,67.25,High,0.4,26900,10760000
Packaged Food,Smith & Jones Red Pasta Sauce Mix,4000,0,6,4000,46,FALSE,46,0,1,2116,86.96,High,0.046,4000,184000
Packaged Food,Kellogg's Muesli Nuts Delight,42500,9,3,38300,750,FALSE,750,4200,1,562500,51.07,High,0.75,38300,28725000
Packaged Food,Kitchens of India Dal Bukhara Gravy Mix,11000,30,6,7700,285,FALSE,285,3300,1,81225,27.02,High,0.285,7700,2194500
Packaged Food,The Whole Truth Peanut Butter - Sweetened & Crunchy,21500,20,6,17200,325,FALSE,325,4300,1,105625,52.92,High,0.325,17200,5590000
Packaged Food,Remia Mayonnaise,23000,0,6,23000,241,FALSE,241,0,1,58081,95.44,High,0.241,23000,5543000
Packaged Food,Ching's Secret Green Chilli Sauce,10500,0,6,10500,425,FALSE,425,0,1,180625,24.71,High,0.425,10500,4462500
Packaged Food,Bagrrys Fruit N Fibre Muesli - Strawberry,59500,0,1,59500,1000,FALSE,1,0,1,1000,59.5,High,1,59500,59500
Packaged Food,Ching's Secret Tomato Oats Instant Soup,1500,0,3,1500,20,FALSE,20,0,1,400,75,Low,0.02,1500,30000
Packaged Food,Kellogg's Special K Original Corn Flakes,14000,5,1,13300,290,FALSE,290,700,1,84100,45.86,High,0.29,13300,3857000
Packaged Food,Moi Soi  Black Bean Sauce - Dip Spread Stir Fry & Marinade,28000,50,5,14000,175,FALSE,175,14000,1,30625,80,High,0.175,14000,2450000
Packaged Food,Tong Garden Wasabi Green Peas,17500,4,6,16700,150,FALSE,150,800,1,22500,111.33,High,0.15,16700,2505000
Packaged Food,Ching's Secret Red Chilli Sauce,10500,0,4,10500,440,FALSE,440,0,1,193600,23.86,High,0.44,10500,4620000
Packaged Food,Ching's Instant Hot and Sour Soup,5500,0,5,5500,55,FALSE,55,0,1,3025,100,High,0.055,5500,302500
Packaged Food,Ching's Secret Noodles - Pad Thai Original,20000,0,6,20000,130,FALSE,130,0,1,16900,153.85,High,0.13,20000,2600000
Packaged Food,Aashirvaad Instant Meals - Khatta Meetha Pohaa With Millets,5500,30,5,3800,80,FALSE,80,1700,1,6400,47.5,High,0.08,3800,304000
Packaged Food,Del Monte Black Sliced Olives,25000,0,1,25000,450,FALSE,450,0,1,202500,55.56,High,0.45,25000,11250000
Packaged Food,Kitchens Of India Murgh Methi,22000,30,5,15400,285,FALSE,285,6600,1,81225,54.04,High,0.285,15400,4389000
Packaged Food,Nestle Cerelac 5 Grains & Fruits Cereal,28800,0,6,28800,300,FALSE,300,0,1,90000,96,High,0.3,28800,8640000
Packaged Food,The Whole Truth - 5 Grain Muesli No Added Sugar,32500,20,6,26000,350,FALSE,350,6500,1,122500,74.29,High,0.35,26000,9100000
Packaged Food,Ching's Secret  Pad Thai Noodles Green Curry,20000,0,6,20000,130,FALSE,130,0,1,16900,153.85,High,0.13,20000,2600000
Packaged Food,Aashirvaad Suji Halwa With Jaggery,7500,0,6,7500,70,FALSE,70,0,1,4900,107.14,High,0.07,7500,525000
Packaged Food,Mother's Recipe Mango Pickle ,12000,0,1,12000,400,FALSE,400,0,1,160000,30,High,0.4,12000,4800000
Packaged Food,Ching's Secret Pad Thai Noodles - Extra Hot Thai Chilli,20000,0,6,20000,130,FALSE,130,0,1,16900,153.85,High,0.13,20000,2600000
Packaged Food,Kellogg's Special K Original Corn Flakes,39900,11,6,35500,900,FALSE,900,4400,1,810000,39.44,High,0.9,35500,31950000
Packaged Food,Knorr Sweet Corn Chicken Soup,5500,0,2,5500,42,FALSE,42,0,1,1764,130.95,High,0.042,5500,231000
Packaged Food,Ching's Secret Tomato Soup,5500,0,6,5500,55,FALSE,55,0,1,3025,100,High,0.055,5500,302500
Packaged Food,Funfoods Peanut Butter Creamy,16900,0,1,16900,400,FALSE,400,0,1,160000,42.25,High,0.4,16900,6760000
Packaged Food,Japanese Choice Udon Noodles,29500,9,6,26600,250,FALSE,250,2900,1,62500,106.4,High,0.25,26600,6650000
Packaged Food,Kelloggs Muesli - With 22% Fruit Magic,32000,10,5,28800,500,FALSE,500,3200,1,250000,57.6,High,0.5,28800,14400000
Packaged Food,Dabur Hommade - Kalonji Tamatar Ki Chutney,6500,6,6,6100,200,FALSE,200,400,1,40000,30.5,High,0.2,6100,1220000
Packaged Food,Kitchens Of India Dal Makhani,11000,30,1,7700,285,FALSE,285,3300,1,81225,27.02,High,0.285,7700,2194500
Packaged Food,Aashirvaad Suji Halwa With Jaggery,5500,30,6,3800,80,FALSE,80,1700,1,6400,47.5,High,0.08,3800,304000
Packaged Food,Del Monte Green Chili Sauce,5500,0,3,5500,190,FALSE,190,0,1,36100,28.95,High,0.19,5500,1045000
Packaged Food,Pedigree Dog Food Adult Chicken & Veg,66000,10,1,59400,3000,FALSE,3,6600,1,9000,19.8,High,3,59400,178200
Packaged Food,Kellogg's Original Corn Flakes,18500,5,6,17500,475,FALSE,475,1000,1,225625,36.84,High,0.475,17500,8312500
Packaged Food,Pedigree Puppy Dry Dog Food Food Chicken & Milk,69000,6,2,64800,3000,FALSE,3,4200,1,9000,21.6,High,3,64800,194400
Packaged Food,Kitchens Of India Rajma Masala,11000,30,5,7700,285,FALSE,285,3300,1,81225,27.02,High,0.285,7700,2194500
Packaged Food,Kitchen Of India Ready-To-Eat Pindi Channa,11000,30,2,7700,285,FALSE,285,3300,1,81225,27.02,High,0.285,7700,2194500
Packaged Food,Figaro Pitted Black Olive ,17900,0,6,17900,450,FALSE,450,0,1,202500,39.78,High,0.45,17900,8055000
Packaged Food,Cantina Tabasco Red Sauce,14000,15,6,11900,60,FALSE,60,2100,1,3600,198.33,High,0.06,11900,714000
Packaged Food,Mother's Recipe Pickle - Mixed,14900,26,6,10900,500,FALSE,500,4000,1,250000,21.8,High,0.5,10900,5450000
Packaged Food,Nestle Cerelac Baby Cereal with Milk 5 Grains & Vegetables from 18 to 24 Month,27900,0,5,27900,300,FALSE,300,0,1,90000,93,High,0.3,27900,8370000
Packaged Food,Mother's Recipe Tamarind Paste,5000,2,2,4900,200,FALSE,200,100,1,40000,24.5,High,0.2,4900,980000
Packaged Food,Pedigree Meat Jerky Adult Dog Treat Barbecued Chicken,14000,20,6,11200,80,FALSE,80,2800,1,6400,140,High,0.08,11200,896000
Packaged Food,Veeba Peri Peri Sauce,16100,0,6,16100,300,FALSE,300,0,1,90000,53.67,High,0.3,16100,4830000
Packaged Food,Pantai Sriracha Yellow Chilli Sauce,22500,15,6,19100,200,FALSE,200,3400,1,40000,95.5,High,0.2,19100,3820000
Packaged Food,Praakritik Organic Jumbo Rolled Oats,19000,11,6,16900,500,FALSE,500,2100,1,250000,33.8,High,0.5,16900,8450000
Packaged Food,Ching's Secret Just Soak - Whole Wheat Veg Hakka Noodles,12300,0,6,12300,600,FALSE,600,0,1,360000,20.5,High,0.6,12300,7380000
Packaged Food,Pantai Spring Roll Sauce,27500,10,6,24500,200,FALSE,200,3000,1,40000,122.5,High,0.2,24500,4900000
Packaged Food,MTR Vermicelli Payasam,7500,0,6,7500,180,FALSE,180,0,1,32400,41.67,High,0.18,7500,1350000
Packaged Food,Bagrrys Corn Flakes,35000,0,6,35000,880,FALSE,800,0,1,704000,39.77,High,0.88,35000,28000000
Packaged Food,MTR Ready To Eat Palak Paneer ,13500,11,6,12000,300,FALSE,300,1500,1,90000,40,High,0.3,12000,3600000
Packaged Food,Del Monte Red Chili Sauce,5500,0,5,5500,190,FALSE,190,0,1,36100,28.95,High,0.19,5500,1045000
Packaged Food,Kitchens of India Mutter Paneer Mix,12000,30,4,8400,285,FALSE,285,3600,1,81225,29.47,High,0.285,8400,2394000
Packaged Food,Pantai Green Curry Paste,6000,6,6,5600,50,FALSE,50,400,1,2500,112,High,0.05,5600,280000
Packaged Food,The Laughing Cow Cheese Spread Plain,11000,0,6,11000,180,FALSE,180,0,1,32400,61.11,High,0.18,11000,1980000
Packaged Food,MTR Dal Fry,11000,0,5,11000,300,FALSE,300,0,1,90000,36.67,High,0.3,11000,3300000
Packaged Food,Pantai Fish Sauce,27500,14,6,23400,200,FALSE,200,4100,1,40000,117,High,0.2,23400,4680000
Packaged Food,Cantina Beans Mexican Beans,25000,14,6,21300,410,FALSE,410,3700,1,168100,51.95,High,0.41,21300,8733000
Packaged Food,Ching's Secret Manchurian Instant Noodle,11400,0,6,11400,480,FALSE,480,0,1,230400,23.75,High,0.48,11400,5472000
Packaged Food,Remia Salad Italian Dressing ,23000,0,6,23000,250,FALSE,250,0,1,62500,92,High,0.25,23000,5750000
Packaged Food,Yummiez Veg Cheese Fingers Pouch,23000,0,4,23000,400,FALSE,400,0,1,160000,57.5,High,0.4,23000,9200000
Packaged Food,MTR Dal Makhani,11000,0,4,11000,300,FALSE,300,0,1,90000,36.67,High,0.3,11000,3300000
Packaged Food,MTR Ready to Eat Pav Bhaji,11000,0,6,11000,300,FALSE,300,0,1,90000,36.67,High,0.3,11000,3300000
Packaged Food,Weikfield Tomato Salsa Instant Pasta,2500,0,1,2500,77,FALSE,77,0,1,5929,32.47,Medium,0.077,2500,192500
Packaged Food,Nestlé CERELAC Baby Cereal with Milk,27200,0,1,27200,300,FALSE,300,0,1,90000,90.67,High,0.3,27200,8160000
Packaged Food,Remia Salad Caesar Dressing,25000,0,6,25000,250,FALSE,250,0,1,62500,100,High,0.25,25000,6250000
Packaged Food,Bagrrys Fruit N Fibre Muesli Mixed Fruit,33000,0,6,33000,500,FALSE,500,0,1,250000,66,High,0.5,33000,16500000
Packaged Food,MTR Paneer Butter Masala & Veg Pulao,17500,9,4,15800,375,FALSE,375,1700,1,140625,42.13,High,0.375,15800,5925000
Packaged Food,Sundrop Cocoa Nut Hazelnut Chocolatey Spread,12000,0,6,12000,160,FALSE,160,0,1,25600,75,High,0.16,12000,1920000
Packaged Food,Moi Soi Manchurian Sauce - For Stir Fry Marinade Spread & Dip,28000,50,6,14000,175,FALSE,175,14000,1,30625,80,High,0.175,14000,2450000
Packaged Food,Pedigree Dog Food Adult Meat & Rice,66000,7,2,60800,3000,FALSE,3,5200,1,9000,20.27,High,3,60800,182400
Packaged Food,Pantai Sriracha Green Chilli Sauce,22500,15,6,19100,200,FALSE,200,3400,1,40000,95.5,High,0.2,19100,3820000
Packaged Food,Pantai Chilli Garlic Sauce,27500,14,6,23400,200,FALSE,200,4100,1,40000,117,High,0.2,23400,4680000
Packaged Food,Pantai Dark Soy Sauce,27500,14,6,23400,200,FALSE,200,4100,1,40000,117,High,0.2,23400,4680000
Packaged Food,Yoga Bar Peanut Butter Dark Chocolate Jar,24900,0,4,24900,400,FALSE,400,0,1,160000,62.25,High,0.4,24900,9960000
Packaged Food,Cantina Tabasco Green Sauce,14000,15,6,11900,60,FALSE,60,2100,1,3600,198.33,High,0.06,11900,714000
Packaged Food,Pantai Pad Thai Sauce (Non-Veg),32500,9,5,29300,200,FALSE,200,3200,1,40000,146.5,High,0.2,29300,5860000
Packaged Food,Pantai Sweet Chilli Sauce,27500,14,6,23400,200,FALSE,200,4100,1,40000,117,High,0.2,23400,4680000
Packaged Food,Ching's Secret Schezwan Instant Noodle,11400,0,6,11400,480,FALSE,480,0,1,230400,23.75,High,0.48,11400,5472000
Packaged Food,Yummiez Chicken Garlic Fingers Pouch,25000,0,5,25000,400,FALSE,400,0,1,160000,62.5,High,0.4,25000,10000000
Packaged Food,Pediasure Premium Chocolate Powdered Health Drink,61000,0,2,61000,400,FALSE,400,0,1,160000,152.5,High,0.4,61000,24400000
Packaged Food,Chings Secret Hot Garlic Instant Noodles,9100,0,6,9100,60,FALSE,60,0,1,3600,151.67,High,0.06,9100,546000
Packaged Food,Godrej Yummiez Cheese Corn Nuggets ,23000,0,4,23000,400,FALSE,400,0,1,160000,57.5,High,0.4,23000,9200000
Packaged Food,Pantai Hot Chilli Sauce,27500,14,6,23400,200,FALSE,200,4100,1,40000,117,High,0.2,23400,4680000
Packaged Food,Knorr International Mexican Tomato Corn Soup ,6500,6,3,6100,52,FALSE,52,400,1,2704,117.31,High,0.052,6100,317200
Packaged Food,Bagrry's Fruit Fibre Muesli Mixed Fruit ,59500,0,5,59500,1000,FALSE,1,0,1,1000,59.5,High,1,59500,59500
Packaged Food,MTR Roasted Vermicelli ,10500,0,4,10500,850,FALSE,850,0,0.9,722500,12.35,High,0.85,10500,8925000
Packaged Food,Maggi 2-Minute Instant Noodles - Masala,4400,0,0,4400,280,TRUE,280,0,0.9,78400,15.71,High,0.28,4400,1232000
Packaged Food,"Kurkure Green Chutney, Rajasthani Style",2000,0,0,2000,90,TRUE,90,0,1,8100,22.22,Medium,0.09,2000,180000
Packaged Food,Kellogg's Chocos Combo Pack,6000,6,0,5600,156,TRUE,156,400,1,24336,35.9,High,0.156,5600,873600
Packaged Food,Kissan Mixed Fruit Jam ,15500,0,0,15500,500,TRUE,500,0,1,250000,31,High,0.5,15500,7750000
Packaged Food,Lijjat Urad Papad,6000,5,0,5700,200,TRUE,200,300,1,40000,28.5,High,0.2,5700,1140000
Packaged Food,Amul Cheese Spread Yummy Plain,8500,0,0,8500,200,TRUE,200,0,1,40000,42.5,High,0.2,8500,1700000
Packaged Food,Mother's Recipe Ginger And Garlic Paste,5000,24,0,3800,200,TRUE,200,1200,1,40000,19,High,0.2,3800,760000
Packaged Food,Maggi Magic Cubes Chicken,4000,2,0,3900,40,TRUE,40,100,1,1600,97.5,High,0.04,3900,156000
Packaged Food,Pedigree Puppy Chicken Chunks in Gravy ,3500,2,0,3400,70,TRUE,70,100,1,4900,48.57,Medium,0.07,3400,238000
Packaged Food,The Whole Truth Peanut Butter - Unsweetened & Crunchy,18500,20,0,14800,325,TRUE,325,3700,1,105625,45.54,High,0.325,14800,4810000
Packaged Food,Ching's Chow Mein Hakka Noodles Masala,1000,0,0,1000,20,TRUE,20,0,1,400,50,Low,0.02,1000,20000
Packaged Food,Safal Frozen Mixed Vegetables,6000,5,0,5700,500,TRUE,500,300,0.9,250000,11.4,High,0.5,5700,2850000
Packaged Food,Safal Frozen Corn,4100,4,0,3900,200,TRUE,200,200,1,40000,19.5,High,0.2,3900,780000
Packaged Food,Amul Cheese Spread Spicy Garlic,8500,3,0,8200,200,TRUE,200,300,1,40000,41,High,0.2,8200,1640000
Packaged Food,Ching's Secret Veg Hakka Noodles,10700,0,0,10700,600,TRUE,600,0,0.9,360000,17.83,High,0.6,10700,6420000
Packaged Food,Saffola Oats 100 % Natural,1500,0,0,1500,38,TRUE,38,0,1,1444,39.47,Low,0.038,1500,57000
Packaged Food,Lijjat Moong Papad,6000,5,0,5700,200,TRUE,200,300,1,40000,28.5,High,0.2,5700,1140000
Packaged Food,Mothers Recipe Papad - Sabudana With Rock Salt,3100,9,0,2800,70,TRUE,70,300,1,4900,40,Medium,0.07,2800,196000
Packaged Food,Maggi Chilly Chow Cuppa Noodles,5000,0,0,5000,70,TRUE,70,0,1,4900,71.43,High,0.07,5000,350000
Packaged Food,Veeba Favourites Eggless Burger Mayonnaise,6900,8,0,6300,250,TRUE,250,600,1,62500,25.2,High,0.25,6300,1575000
Packaged Food,Sunfeast Yippee! Magic Masala Noodles,4800,6,0,4500,240,TRUE,240,300,1,57600,18.75,High,0.24,4500,1080000
Packaged Food,Top Ramen Masala,9100,9,0,8200,560,TRUE,560,900,0.9,313600,14.64,High,0.56,8200,4592000
Packaged Food,Kelloggs Corn Flakes With Real Strawberry Pure,26500,10,0,23600,575,TRUE,575,2900,1,330625,41.04,High,0.575,23600,13570000
Packaged Food,Mother's Recipe Potato Papad,3100,9,0,2800,70,TRUE,75,300,1,5250,40,Medium,0.07,2800,210000
Packaged Food,Mothers Recipe Rice Papad Ajwain,2400,0,0,2400,75,TRUE,75,0,1,5625,32,Medium,0.075,2400,180000
Packaged Food,Chef's Basket Durum Wheat Penne Pasta,16000,50,0,8000,500,TRUE,500,8000,1,250000,16,High,0.5,8000,4000000
Packaged Food,Dabur Hommade - Imli Sauce Saunth,2000,10,0,1800,100,TRUE,100,200,1,10000,18,Medium,0.1,1800,180000
Packaged Food,Zorabian Chicken Kheema Parathas,19000,0,0,19000,300,TRUE,300,0,1,90000,63.33,High,0.3,19000,5700000
Packaged Food,Sunfeast Pasta Treat Pack of Tomato Cheese,2800,17,0,2300,65,TRUE,65,500,1,4225,35.38,Medium,0.065,2300,149500
Packaged Food,Safal Frozen - Sweet Corn,16000,5,0,15200,1000,TRUE,1,800,0.9,1000,15.2,High,1,15200,15200
Packaged Food,MTR Vegetable Upma,2500,0,0,2500,60,TRUE,60,0,1,3600,41.67,Medium,0.06,2500,150000
Packaged Food,Del Monte Original Blend Tomato Ketchup Pouch,12000,7,0,11100,950,TRUE,950,900,0.9,902500,11.68,High,0.95,11100,10545000
Packaged Food,Del Monte Natural Vinegar ,5500,3,0,5300,180,TRUE,180,200,1,32400,29.44,High,0.18,5300,954000
Packaged Food,Del Monte Eggless Mayo,13500,6,0,12600,500,TRUE,500,900,1,250000,25.2,High,0.5,12600,6300000
Packaged Food,ITC Master Chef Cheesy Corn Triangles,16000,5,0,15200,320,TRUE,320,800,1,102400,47.5,High,0.32,15200,4864000
Packaged Food,Mother's Recipe Mixed Pickle ,11500,4,0,11000,400,TRUE,400,500,1,160000,27.5,High,0.4,11000,4400000
Packaged Food,Godrej Yummiez Chicken Breakfast Salami,15000,4,0,14300,250,TRUE,250,700,1,62500,57.2,High,0.25,14300,3575000
Packaged Food,Hershey's Cocoa + Almond Spread,29500,9,0,26600,350,TRUE,350,2900,1,122500,76,High,0.35,26600,9310000
Packaged Food,Maggi Special Masala Spicy Yummy Noodles,7200,0,0,7200,280,TRUE,280,0,1,78400,25.71,High,0.28,7200,2016000
Packaged Food,Del Monte Schezwan Sauce,5500,0,0,5500,190,TRUE,190,0,1,36100,28.95,High,0.19,5500,1045000
Packaged Food,Yummiez Green Peas,13500,0,0,13500,500,TRUE,500,0,1,250000,27,High,0.5,13500,6750000
Packaged Food,Yummiez Green Peas,25000,0,0,25000,1000,TRUE,1,0,1,1000,25,High,1,25000,25000
Packaged Food,Yummiez American Sweet Corn,8500,0,0,8500,400,TRUE,400,0,1,160000,21.25,High,0.4,8500,3400000
Packaged Food,Dr Oetker Cucumber & Carrot Sandwich Spread Veg,7900,0,0,7900,250,TRUE,250,0,1,62500,31.6,High,0.25,7900,1975000
Packaged Food,Del Monte Pitted Green Olives,25000,0,0,25000,450,TRUE,450,0,1,202500,55.56,High,0.45,25000,11250000
Ice Cream & Desserts,Maggi 2 Minute Masala Noodles,1200,0,6,1200,70,FALSE,70,0,0.9,4900,17.14,Low,0.07,1200,84000
Ice Cream & Desserts,iD Idli & Dosa Batter ,8000,15,6,6800,1000,FALSE,1,1200,0.9,1000,6.8,High,1,6800,6800
Ice Cream & Desserts,iD Malabar Parota ,8000,10,4,7200,400,FALSE,400,800,1,160000,18,High,0.4,7200,2880000
Ice Cream & Desserts,iD Wheat Lachha Paratha,8000,12,6,7000,400,FALSE,400,1000,1,160000,17.5,High,0.4,7000,2800000
Ice Cream & Desserts,McCain Aloo Tikki,11000,4,6,10500,400,FALSE,400,500,1,160000,26.25,High,0.4,10500,4200000
Ice Cream & Desserts,McCain Smiles Cripsy Happy Potatoes,12000,5,6,11400,415,FALSE,415,600,1,172225,27.47,High,0.415,11400,4731000
Ice Cream & Desserts,McCain Veggie Burger Patty,11500,3,6,11100,360,FALSE,360,400,1,129600,30.83,High,0.36,11100,3996000
Ice Cream & Desserts,McCain Veggie Fingers,11700,5,6,11100,400,FALSE,400,600,1,160000,27.75,High,0.4,11100,4440000
Ice Cream & Desserts,Amul Delicious Fat Spread - Cholesterol Free,1800,5,6,1700,100,FALSE,100,100,0.9,10000,17,Low,0.1,1700,170000
Ice Cream & Desserts,Whiskas Wet  Meal (Adult - Cat Food)  Chicken in Gravy,3500,2,2,3400,85,FALSE,85,100,1,7225,40,Medium,0.085,3400,289000
Ice Cream & Desserts,McCain Chilli Garlic Potato Bites Crunchy Potato Nuggets,12500,5,1,11800,420,FALSE,420,700,1,176400,28.1,High,0.42,11800,4956000
Ice Cream & Desserts,Ching's Secret Instant Hot Garlic Noodles,1500,0,3,1500,60,FALSE,60,0,1,3600,25,Low,0.06,1500,90000
Ice Cream & Desserts,Veeba Eggless Mayonnaise,7900,11,5,7000,250,FALSE,250,900,1,62500,28,High,0.25,7000,1750000
Ice Cream & Desserts,Ching's Secret Instant Schezwan Noodles,1500,0,6,1500,60,FALSE,60,0,1,3600,25,Low,0.06,1500,90000
Ice Cream & Desserts,Veeba Pasta And Pizza Sauce,7500,13,5,6500,280,FALSE,280,1000,1,78400,23.21,High,0.28,6500,1820000
Ice Cream & Desserts,Top Ramen  Noodles Curry Veg Pouch,2000,0,1,2000,70,FALSE,70,0,1,4900,28.57,Medium,0.07,2000,140000
Ice Cream & Desserts,Saffola Veggie Twist Masala Oats,1500,0,6,1500,38,FALSE,38,0,1,1444,39.47,Low,0.038,1500,57000
Ice Cream & Desserts,Unibic Almond & Oats Protein Bar,4000,17,4,3300,30,FALSE,30,700,1,900,110,High,0.03,3300,99000
Ice Cream & Desserts,Quaker Oats,7900,0,2,7900,400,FALSE,400,0,0.9,160000,19.75,High,0.4,7900,3160000
Ice Cream & Desserts,Amul Delicious Fat Spread - Cholesterol Free,8800,2,2,8600,500,FALSE,500,200,0.9,250000,17.2,High,0.5,8600,4300000
Ice Cream & Desserts,McCain French Fries,12000,5,1,11400,420,FALSE,420,600,1,176400,27.14,High,0.42,11400,4788000
Ice Cream & Desserts,Ching's Secret Manchow Instant Soup,1000,0,1,1000,15,FALSE,15,0,1,225,66.67,Low,0.015,1000,15000
Ice Cream & Desserts,McCain Potato Cheese Shotz,13000,4,6,12400,250,FALSE,250,600,1,62500,49.6,High,0.25,12400,3100000
Ice Cream & Desserts,McCain Masala - Fries,12000,5,3,11400,375,FALSE,375,600,1,140625,30.4,High,0.375,11400,4275000
Ice Cream & Desserts,Ching's Secret Schezwan Fried Rice Masala,1500,0,6,1500,20,FALSE,20,0,1,400,75,Low,0.02,1500,30000
Ice Cream & Desserts,McCain New Mini Samosa with Cheese Pizza Style Filling,12000,1,3,11800,240,FALSE,240,200,1,57600,49.17,High,0.24,11800,2832000
Ice Cream & Desserts,McCain Chilli Cheesy Nuggets,13000,4,1,12400,250,FALSE,250,600,1,62500,49.6,High,0.25,12400,3100000
Ice Cream & Desserts,"Whiskas Adult (+1 Year) Dry Cat Food, Ocean Fish Flavour",43000,10,6,38700,1200,FALSE,1,4300,1,1200,32.25,High,1.2,38700,38700
Ice Cream & Desserts,Chings Instant Soup - Hot & Sour,1000,0,1,1000,15,FALSE,15,0,1,225,66.67,Low,0.015,1000,15000
Ice Cream & Desserts,Amul Spray Infant Milk Food,19700,2,6,19300,500,FALSE,500,400,1,250000,38.6,High,0.5,19300,9650000
Ice Cream & Desserts,McCain Smiles - Pudina Chatka,12000,5,3,11400,375,FALSE,375,600,1,140625,30.4,High,0.375,11400,4275000
Ice Cream & Desserts,McCain French Fries Crisp & Delicious,17500,4,3,16700,750,FALSE,750,800,1,562500,22.27,High,0.75,16700,12525000
Ice Cream & Desserts,Ferrero Nutella Hazelnut Spread,22000,5,2,20700,180,FALSE,180,1300,1,32400,115,High,0.18,20700,3726000
Ice Cream & Desserts,Lijjat Garlic Papad,6000,5,5,5700,200,FALSE,200,300,1,40000,28.5,High,0.2,5700,1140000
Ice Cream & Desserts,Switz Samosa Dough Sheets,9000,4,6,8600,50,FALSE,50,400,1,2500,172,High,0.05,8600,430000
Ice Cream & Desserts,Amul Cheese Spread Creamy,8500,5,6,8000,180,FALSE,180,500,1,32400,44.44,High,0.18,8000,1440000
Ice Cream & Desserts,Maggi Imli Sauce Pichkoo,2200,0,6,2200,90,FALSE,90,0,1,8100,24.44,Medium,0.09,2200,198000
Ice Cream & Desserts,Whiskas Kitten (2-12 months) Dry Cat Food Food Ocean Fish,38500,9,5,34700,1100,FALSE,1100,3800,1,1210000,31.55,High,1.1,34700,38170000
Ice Cream & Desserts,Chings Instant Soup - Sweet Corn Veg,1000,0,2,1000,15,FALSE,15,0,1,225,66.67,Low,0.015,1000,15000
Ice Cream & Desserts,Whiskas Wet  Meal (Kitten - Cat Food)  Chicken in Gravy,3500,5,2,3300,85,FALSE,85,200,1,7225,38.82,Medium,0.085,3300,280500
Ice Cream & Desserts,McCain Crazy Fries Masala MixHot 'n' Tangy,12000,5,6,11400,400,FALSE,400,600,1,160000,28.5,High,0.4,11400,4560000
Ice Cream & Desserts,The Whole Truth Double Cocoa Protein Bar No Sugar,10000,10,6,9000,52,FALSE,52,1000,1,2704,173.08,High,0.052,9000,468000
Ice Cream & Desserts,Amul Happy Treats French Fries,6800,4,1,6500,425,FALSE,425,300,0.9,180625,15.29,High,0.425,6500,2762500
Ice Cream & Desserts,Ferrero Nutella Hazeulnut Spread,38000,6,5,35700,350,FALSE,350,2300,1,122500,102,High,0.35,35700,12495000
Ice Cream & Desserts,Veeba Chipolte Southwest Dressing,16100,7,4,14900,300,FALSE,300,1200,1,90000,49.67,High,0.3,14900,4470000
Ice Cream & Desserts,Ching's Secret Manchow Noodles Instant Soup,1500,0,6,1500,20,FALSE,20,0,1,400,75,Low,0.02,1500,30000
Ice Cream & Desserts,Yoga Bar Breakfast Protein Bar - Blueberry Pie,5000,12,1,4400,50,FALSE,50,600,1,2500,88,High,0.05,4400,220000
Ice Cream & Desserts,Quaker Oats,19900,7,6,18400,1000,FALSE,1,1500,0.9,1000,18.4,High,1,18400,18400
Ice Cream & Desserts,The Whole Truth Mini Protein Bar - Coconut Cocoa No Added Sugar,5500,25,6,4100,27,FALSE,27,1400,1,729,151.85,High,0.027,4100,110700
Ice Cream & Desserts,Switz Spring Roll Dough Sheets,9000,4,6,8600,1160,FALSE,20,400,0.9,23200,7.41,High,1.16,8600,172000
Ice Cream & Desserts,Unibic Fruit & Nut Real Cranberries & Almonds Protein Bar,4000,17,6,3300,30,FALSE,30,700,1,900,110,High,0.03,3300,99000
Ice Cream & Desserts,Ching's Secret Tomato Instant Soup,1000,0,1,1000,16,FALSE,15,0,1,240,62.5,Low,0.016,1000,15000
Ice Cream & Desserts,Chef's Basket Durum Wheat Elbow Pasta,16000,50,6,8000,500,FALSE,500,8000,1,250000,16,High,0.5,8000,4000000
Ice Cream & Desserts,Sunfeast Yippee! Mood Masala Noodles,6000,28,3,4300,260,FALSE,260,1700,1,67600,16.54,High,0.26,4300,1118000
Ice Cream & Desserts,MTR Breakfast Khatta Meetha Poha Mix,2500,20,6,2000,60,FALSE,60,500,1,3600,33.33,Medium,0.06,2000,120000
Ice Cream & Desserts,Kellogg's Crunchy Fruit & Nut Breakfast Cereals Muesli,44500,9,6,40100,750,FALSE,750,4400,1,562500,53.47,High,0.75,40100,30075000
Ice Cream & Desserts,Ching's Secret Chilli Vinegar,5000,0,4,5000,170,FALSE,170,0,1,28900,29.41,High,0.17,5000,850000
Ice Cream & Desserts,Ching's Red Chilli Sauce,5500,0,6,5500,200,FALSE,200,0,1,40000,27.5,High,0.2,5500,1100000
Ice Cream & Desserts,Amul Lite Spread,4000,2,5,3900,100,FALSE,100,100,1,10000,39,High,0.1,3900,390000
Ice Cream & Desserts,Borges Durum Wheat Fusilli Pasta ,25000,0,3,25000,500,FALSE,500,0,1,250000,50,High,0.5,25000,12500000
Ice Cream & Desserts,The Whole Truth Cranberry Mini Protein Bar No Sugar,5500,20,6,4400,27,FALSE,27,1100,1,729,162.96,High,0.027,4400,118800
Ice Cream & Desserts,The Whole Truth Mini Protein Bar - Coffee Cocoa No Added Sugar,5500,20,6,4400,27,FALSE,27,1100,1,729,162.96,High,0.027,4400,118800
Ice Cream & Desserts,Maggi Hot & Sweet Tomato Chilli Sauce,11500,0,1,11500,500,FALSE,500,0,1,250000,23,High,0.5,11500,5750000
Ice Cream & Desserts,Sunfeast YiPPee! Noodles - Magic Masala,9600,5,4,9100,540,FALSE,540,500,0.9,291600,16.85,High,0.54,9100,4914000
Ice Cream & Desserts,Chef's Basket Durum Wheat Fusilli Pasta,16000,50,6,8000,500,FALSE,500,8000,1,250000,16,High,0.5,8000,4000000
Ice Cream & Desserts,Top Ramen Chicken Noodles,6000,10,1,5400,280,FALSE,280,600,1,78400,19.29,High,0.28,5400,1512000
Ice Cream & Desserts,Veeba Cheese and Chilli Sandwich Spread,8900,11,6,7900,275,FALSE,275,1000,1,75625,28.73,High,0.275,7900,2172500
Ice Cream & Desserts,Chings Secret Chowmein Hakka Noodles Masala ,4400,0,2,4400,60,FALSE,60,0,1,3600,73.33,High,0.06,4400,264000
Ice Cream & Desserts,Safal Frozen - Mixed Vegetables,11000,4,2,10500,1000,FALSE,1,500,0.9,1000,10.5,High,1,10500,10500
Ice Cream & Desserts,MTR 3 Min Poha,2500,0,6,2500,60,FALSE,60,0,1,3600,41.67,Medium,0.06,2500,150000
Ice Cream & Desserts,Ching's Manchurian Instant Noodles,1500,0,5,1500,60,FALSE,60,0,1,3600,25,Low,0.06,1500,90000
Ice Cream & Desserts,The Whole Truth Peanut Cocoa Mini Protein Bar No Sugar ,5500,25,6,4100,27,FALSE,27,1400,1,729,151.85,High,0.027,4100,110700
Ice Cream & Desserts,Gits Pav Bhaji Ready to Eat,11000,22,6,8500,300,FALSE,300,2500,1,90000,28.33,High,0.3,8500,2550000
Ice Cream & Desserts,McCain New Mini Samosa with Cheese Corn Style Filling,12000,1,2,11800,240,FALSE,240,200,1,57600,49.17,High,0.24,11800,2832000
Ice Cream & Desserts,Lijjat Udad Mini Papad,6000,6,6,5600,200,FALSE,200,400,1,40000,28,High,0.2,5600,1120000
Ice Cream & Desserts,McCain Herb & Garlic Crazy Fries Masala Mix ,12000,5,5,11400,400,FALSE,400,600,1,160000,28.5,High,0.4,11400,4560000
Ice Cream & Desserts,Yoga Bar Multigrain Energy Bar Nuts And Seeds,4000,12,4,3500,38,FALSE,38,500,1,1444,92.11,High,0.038,3500,133000
Ice Cream & Desserts,"Ching's Secret Sauce, Green Chilli",5500,0,5,5500,190,FALSE,190,0,1,36100,28.95,High,0.19,5500,1045000
Ice Cream & Desserts,Veeba Pizza Topping,7500,6,4,7000,280,FALSE,280,500,1,78400,25,High,0.28,7000,1960000
Ice Cream & Desserts,Switz Paratha Puff,11000,4,6,10500,400,FALSE,400,500,1,160000,26.25,High,0.4,10500,4200000
Ice Cream & Desserts,"New Kellogg's Muesli with 21% Fruit, Nut & Seeds",32500,6,6,30500,500,FALSE,500,2000,1,250000,61,High,0.5,30500,15250000
Ice Cream & Desserts,The Whole Truth Double Cocoa Mini Protein Bar No Sugar,5500,20,5,4400,27,FALSE,27,1100,1,729,162.96,High,0.027,4400,118800
Ice Cream & Desserts,Sunfeast Yippee Tricolor Pasta Seasoning,2800,17,1,2300,65,FALSE,65,500,1,4225,35.38,Medium,0.065,2300,149500
Ice Cream & Desserts,Wingreens Cheesy Chipotle Sauce,9900,49,1,5000,130,FALSE,130,4900,1,16900,38.46,High,0.13,5000,650000
Ice Cream & Desserts,Maggi Rich Tomato Ketchup,10500,4,2,10000,500,FALSE,500,500,1,250000,20,High,0.5,10000,5000000
Ice Cream & Desserts,The Whole Truth Dark Chocolate Peanut Butter - Creamy,23500,25,6,17400,325,FALSE,325,6100,1,105625,53.54,High,0.325,17400,5655000
Ice Cream & Desserts,Godrej Yummiez Chicken Nuggets,32500,9,1,29300,500,FALSE,500,3200,1,250000,58.6,High,0.5,29300,14650000
Ice Cream & Desserts,Go Cheese  Spread Plain,9900,5,6,9400,200,FALSE,200,500,1,40000,47,High,0.2,9400,1880000
Ice Cream & Desserts,Kellogg's Real Almond & Honey Corn Flakes,17500,9,6,15800,300,FALSE,300,1700,1,90000,52.67,High,0.3,15800,4740000
Ice Cream & Desserts,The Whole Truth Vegan Almond Choco Fudge Energy Bar No Sugar,6000,20,6,4800,40,FALSE,40,1200,1,1600,120,High,0.04,4800,192000
Ice Cream & Desserts,Prasuma Vegetable Momos,27000,0,5,27000,24,FALSE,24,0,1,576,1125,High,0.024,27000,648000
Ice Cream & Desserts,MTR Upma,5000,10,6,4500,160,FALSE,160,500,1,25600,28.13,High,0.16,4500,720000
Ice Cream & Desserts,Ching's Schezwan Masala Instant Noodles,6000,0,1,6000,240,FALSE,240,0,1,57600,25,High,0.24,6000,1440000
Ice Cream & Desserts,The Whole Truth Cranberry Protein Bar No Sugar,10000,26,6,7400,52,FALSE,52,2600,1,2704,142.31,High,0.052,7400,384800
Ice Cream & Desserts,Saffola Yummy Masala Noodles ,2000,0,2,2000,46,FALSE,46,0,1,2116,43.48,Medium,0.046,2000,92000
Ice Cream & Desserts,Veeba English Mustard,7400,6,2,6900,300,FALSE,300,500,1,90000,23,High,0.3,6900,2070000
Ice Cream & Desserts,Dabur Hommade Tamarind Paste,4800,6,6,4500,200,FALSE,200,300,1,40000,22.5,High,0.2,4500,900000
Ice Cream & Desserts,Yoga Bar Breakfast Muesli - Almond Caramel (No Added Sugar),32500,4,6,30900,400,FALSE,400,1600,1,160000,77.25,High,0.4,30900,12360000
Ice Cream & Desserts,The Whole Truth Mini Protein Bar - Peanut Butter No Added Sugar,5500,25,6,4100,27,FALSE,27,1400,1,729,151.85,High,0.027,4100,110700
Ice Cream & Desserts,ITC Master Chef Crispy Chicken Fries ,17000,4,3,16200,280,FALSE,280,800,1,78400,57.86,High,0.28,16200,4536000
Ice Cream & Desserts,Kelloggs Corn Flakes,9900,13,6,8600,250,FALSE,250,1300,1,62500,34.4,High,0.25,8600,2150000
Ice Cream & Desserts,Nissin Cup Noodles Tangy Tomato,5000,10,2,4500,70,FALSE,70,500,1,4900,64.29,High,0.07,4500,315000
Ice Cream & Desserts,Smith & Jones White Pasta Sauce Mix,4000,0,3,4000,46,FALSE,46,0,1,2116,86.96,High,0.046,4000,184000
Ice Cream & Desserts,Sunfeast Yippee! Pasta Treat - Sour Cream Onion,2800,10,1,2500,65,FALSE,65,300,1,4225,38.46,Medium,0.065,2500,162500
Ice Cream & Desserts,Mothers Recipe Tamrind Date Chutney ,5500,9,2,5000,200,FALSE,200,500,1,40000,25,High,0.2,5000,1000000
Ice Cream & Desserts,Veeba Mint Mayonnaise,16900,8,4,15500,300,FALSE,300,1400,1,90000,51.67,High,0.3,15500,4650000
Ice Cream & Desserts,Mccain Emotibites - Crispy Happy Potato Snack,13000,0,6,12900,415,FALSE,415,100,1,172225,31.08,High,0.415,12900,5353500
Ice Cream & Desserts,The Whole Truth Energy Bar Choco Cranberry Fudge,6000,26,6,4400,40,FALSE,40,1600,1,1600,110,High,0.04,4400,176000
Ice Cream & Desserts,Godrej Yummiez Chicken Lucknowi Seekh Kebab,26000,10,4,23400,400,FALSE,400,2600,1,160000,58.5,High,0.4,23400,9360000
Ice Cream & Desserts,Prasuma Vegetable Momos,15000,0,5,15000,580,FALSE,10,0,1,5800,25.86,High,0.58,15000,150000
Ice Cream & Desserts,Mother's Recipe Mixed Pickle,8500,9,2,7700,300,FALSE,300,800,1,90000,25.67,High,0.3,7700,2310000
Ice Cream & Desserts,Sunfeast Yippee! Pasta Treat - Sour Cream Onion,2800,17,3,2300,65,FALSE,65,500,1,4225,35.38,Medium,0.065,2300,149500
Ice Cream & Desserts,The Whole Truth Peanut Cocoa Protein Bar No Sugar,10000,26,6,7400,52,FALSE,52,2600,1,2704,142.31,High,0.052,7400,384800
Ice Cream & Desserts,Yoga Bar Breakfast Muesli - Chocolate & Cranberry ,32500,4,6,30900,400,FALSE,400,1600,1,160000,77.25,High,0.4,30900,12360000
Ice Cream & Desserts,Sunfeast YiPPee! Magic Masala Noodles,7000,10,3,6300,405,FALSE,405,700,0.9,164025,15.56,High,0.405,6300,2551500
Ice Cream & Desserts,Veeba Sweet Onion Sauce,14100,14,4,12100,350,FALSE,350,2000,1,122500,34.57,High,0.35,12100,4235000
Ice Cream & Desserts,Quaker Oats Breakfast Cereals - With Flavour Mix Nutritious Rich Source Of Energy,4900,8,6,4500,200,FALSE,200,400,1,40000,22.5,High,0.2,4500,900000
Ice Cream & Desserts,Mother's Recipe Tamarind Paste,5000,2,6,4900,200,FALSE,200,100,1,40000,24.5,High,0.2,4900,980000
Ice Cream & Desserts,Yogabar No Added Sugar Protein Bar Brownie,12500,15,4,10600,60,FALSE,60,1900,1,3600,176.67,High,0.06,10600,636000
Ice Cream & Desserts,Bambino Popular Vermicelli ,4000,2,3,3900,400,FALSE,400,100,0.9,160000,9.75,High,0.4,3900,1560000
Ice Cream & Desserts,Ching's Secret Mix Veg Instant Soup,1000,0,3,1000,15,FALSE,15,0,1,225,66.67,Low,0.015,1000,15000
Ice Cream & Desserts,Mother's Recipe Pickle - Red Stuffed Chilli,14500,11,3,12900,400,FALSE,400,1600,1,160000,32.25,High,0.4,12900,5160000
Ice Cream & Desserts,Kellogg's No Added Sugar Muesli,33500,11,6,29800,500,FALSE,500,3700,1,250000,59.6,High,0.5,29800,14900000
Ice Cream & Desserts,Veeba Salsa Dip,11900,6,6,11100,360,FALSE,360,800,1,129600,30.83,High,0.36,11100,3996000
Ice Cream & Desserts,Veeba Thousand Island Dressing,14900,8,6,13700,300,FALSE,300,1200,1,90000,45.67,High,0.3,13700,4110000
Ice Cream & Desserts,Baggry's Crunchy Muesli Almond Raisins & Honey,13000,0,5,13000,200,FALSE,200,0,1,40000,65,High,0.2,13000,2600000
Ice Cream & Desserts,Knorr Chinese Hot And Sour Veg Soup,5500,3,1,5300,43,FALSE,43,200,1,1849,123.26,High,0.043,5300,227900
Ice Cream & Desserts,Go Cheese Spread - Garlic,9900,5,6,9400,200,FALSE,200,500,1,40000,47,High,0.2,9400,1880000
Ice Cream & Desserts,The Whole Truth Peanut Butter With Dates - Creamy No Sugar,21500,9,6,19400,325,FALSE,325,2100,1,105625,59.69,High,0.325,19400,6305000
Ice Cream & Desserts,Zorabian Chicken Smoked Ham,20500,5,1,19400,250,FALSE,250,1100,1,62500,77.6,High,0.25,19400,4850000
Ice Cream & Desserts,Kissan Pineapple Jam,16500,9,1,14900,500,FALSE,500,1600,1,250000,29.8,High,0.5,14900,7450000
Ice Cream & Desserts,Smith & Jones Masala Noodles,8900,0,5,8900,480,FALSE,480,0,0.9,230400,18.54,High,0.48,8900,4272000
Ice Cream & Desserts,Nestle Nestle Nan Pro Follow-Up Formula,65000,0,6,65000,400,FALSE,400,0,1,160000,162.5,High,0.4,65000,26000000
Ice Cream & Desserts,Sunfeast Yippee! Power Up Atta Noodles,9600,15,6,8100,280,FALSE,280,1500,1,78400,28.93,High,0.28,8100,2268000
Ice Cream & Desserts,McCain Super Wedges,12000,7,6,11100,400,FALSE,400,900,1,160000,27.75,High,0.4,11100,4440000
Ice Cream & Desserts,"Kellogg's Crunchy Granola Honey, Almonds, Strawberries & Pumpkin Seeds",33000,10,1,29400,450,FALSE,450,3600,1,202500,65.33,High,0.45,29400,13230000
Ice Cream & Desserts,Kellogg's Chocos,13000,10,6,11700,250,FALSE,250,1300,1,62500,46.8,High,0.25,11700,2925000
Ice Cream & Desserts,Ching's Secret Just Soak - Whole Wheat Veg Hakka Noodle,3200,0,3,3200,150,FALSE,150,0,1,22500,21.33,Medium,0.15,3200,480000
Ice Cream & Desserts,The Whole Truth Vegan Fig Apricot & Orange Energy Bar No Sugar,6000,20,6,4800,40,FALSE,40,1200,1,1600,120,High,0.04,4800,192000
Ice Cream & Desserts,Saffola Veggie Twist Masala Oats,19500,12,2,17100,500,FALSE,500,2400,1,250000,34.2,High,0.5,17100,8550000
Ice Cream & Desserts,ITC Master Chef Classic Aloo Tikki,8000,10,3,7200,320,FALSE,320,800,1,102400,22.5,High,0.32,7200,2304000
Ice Cream & Desserts,Smith & Jones Pink Pasta Sauce Mix,4000,0,4,4000,46,FALSE,46,0,1,2116,86.96,High,0.046,4000,184000
Ice Cream & Desserts,Wingreens Farms Chipotle Dip,20000,25,1,15000,180,FALSE,180,5000,1,32400,83.33,High,0.18,15000,2700000
Ice Cream & Desserts,Kellogg's Real Almond & Honey Corn Flakes,55000,5,3,52000,1000,FALSE,1,3000,1,1000,52,High,1,52000,52000
Ice Cream & Desserts,Kellogg's Crunchy Granola Chocolate & Almonds,33000,10,3,29400,450,FALSE,450,3600,1,202500,65.33,High,0.45,29400,13230000
Ice Cream & Desserts,Cornitos Cornitos Taco Shells - 6 Inches,16000,20,4,12800,180,FALSE,180,3200,1,32400,71.11,High,0.18,12800,2304000
Ice Cream & Desserts,Ching's Secret Singapore Curry Instant Noodles,1500,0,3,1500,60,FALSE,60,0,1,3600,25,Low,0.06,1500,90000
Ice Cream & Desserts,Mother's Recipe Pickle - Mango,12500,9,6,11300,400,FALSE,500,1200,1,200000,28.25,High,0.4,11300,5650000
Ice Cream & Desserts,Godrej Yummiez Chilli Chicken Sausages ,16000,10,3,14400,250,FALSE,250,1600,1,62500,57.6,High,0.25,14400,3600000
Ice Cream & Desserts,Pedigree Dentastix  Dog Treat Oral Care for Adult Medium Breed ,17500,20,6,14000,180,FALSE,180,3500,1,32400,77.78,High,0.18,14000,2520000
Ice Cream & Desserts,Maggi Hot & Sweet - Tomato Chilli Sauce,17000,10,1,15300,1000,FALSE,1,1700,0.9,1000,15.3,High,1,15300,15300
Ice Cream & Desserts,Ching's Secret Asian Hot Instant Soup,1500,0,3,1500,15,FALSE,15,0,1,225,100,Low,0.015,1500,22500
Ice Cream & Desserts,Kelloggs Chocos Protein And Fibre Of 1 Roti,49900,11,6,44400,1200,FALSE,1,5500,1,1200,37,High,1.2,44400,44400
Ice Cream & Desserts,Mother's Recipe Pickle - Mango,14900,26,4,10900,500,FALSE,500,4000,1,250000,21.8,High,0.5,10900,5450000
Ice Cream & Desserts,Chings Secret Manchurian Instant Noodle,6000,0,6,6000,240,FALSE,240,0,1,57600,25,High,0.24,6000,1440000
Ice Cream & Desserts,Kellogg's Original Corn Flakes,31000,6,6,29000,875,FALSE,875,2000,1,765625,33.14,High,0.875,29000,25375000
Ice Cream & Desserts,Ching's Singapore Curry Instant Noodles,6000,0,4,6000,240,FALSE,240,0,1,57600,25,High,0.24,6000,1440000
Ice Cream & Desserts,Kellogg's Almonds And Cranberries Granola,33000,6,6,31000,460,FALSE,460,2000,1,211600,67.39,High,0.46,31000,14260000
Ice Cream & Desserts,Nestle Ceregrow Multigrain Cereal with Milk and Fruits - 3 to 6 years,29200,0,6,29200,300,FALSE,300,0,1,90000,97.33,High,0.3,29200,8760000
Ice Cream & Desserts,MTR 3 Minute Breakfast - Magic Masala Upma,2500,0,6,2500,60,FALSE,60,0,1,3600,41.67,Medium,0.06,2500,150000
Ice Cream & Desserts,Smith & Jones Masala Noodles,6800,10,5,6100,360,FALSE,360,700,0.9,129600,16.94,High,0.36,6100,2196000
Ice Cream & Desserts,"Knorr Classic Tomato Soup With 100% Real Vegetabls, No Added Preservatives",5500,0,6,5500,53,FALSE,53,0,1,2809,103.77,High,0.053,5500,291500
Ice Cream & Desserts,Godrej Yummiez Chicken Punjabi Tikka ,29500,9,6,26600,360,FALSE,360,2900,1,129600,73.89,High,0.36,26600,9576000
Ice Cream & Desserts,Kellogg's Corn Flakes,42500,9,1,38300,1000,FALSE,1,4200,1,1000,38.3,High,1,38300,38300
Ice Cream & Desserts,Kelloggs Chocos,17000,5,4,16000,385,FALSE,385,1000,1,148225,41.56,High,0.385,16000,6160000
Ice Cream & Desserts,Pedigree Puppy Dry Dog Food Food Chicken & Milk,29000,20,6,23200,1200,FALSE,1200,5800,1,1440000,19.33,High,1.2,23200,27840000
Ice Cream & Desserts,Ching's Secret Lemon Coriander Instant Soup,1500,0,5,1500,15,FALSE,15,0,1,225,100,Low,0.015,1500,22500
Ice Cream & Desserts,Nestle Cerelac Baby Cereal With Milk Wheat-Rice Mixed Fruit,26100,0,6,26100,300,FALSE,300,0,1,90000,87,High,0.3,26100,7830000
Ice Cream & Desserts,Kelloggs Chocos - Moons & Stars,66000,40,4,39600,1200,FALSE,1,26400,1,1200,33,High,1.2,39600,39600
Ice Cream & Desserts,ITC Master Chef Chicken Galouti Kebab,17000,4,2,16200,210,FALSE,210,800,1,44100,77.14,High,0.21,16200,3402000
Ice Cream & Desserts,Yogabar 100% Pure Peanut Butter Creamy & Yummy Unsweetened,22900,10,6,20600,400,FALSE,400,2300,1,160000,51.5,High,0.4,20600,8240000
Ice Cream & Desserts,Kitchens Of India Palak Paneer,13000,30,6,9100,285,FALSE,285,3900,1,81225,31.93,High,0.285,9100,2593500
Ice Cream & Desserts,Kelloggs Chocos Fills Double Chocolat,9900,11,6,8800,175,FALSE,175,1100,1,30625,50.29,High,0.175,8800,1540000
Ice Cream & Desserts,Soulfull Ragi Bites Choco Fills,16900,5,4,16000,250,FALSE,250,900,1,62500,64,High,0.25,16000,4000000
Ice Cream & Desserts,Figaro Sliced Black Olive ,17900,0,6,17900,450,FALSE,450,0,1,202500,39.78,High,0.45,17900,8055000
Ice Cream & Desserts,Veeba Barbeque Sauce,14900,8,6,13700,330,FALSE,330,1200,1,108900,41.52,High,0.33,13700,4521000
Ice Cream & Desserts,The Whole Truth Vegan Mocha Almond Fudge Energy Bar No Sugar,6000,20,6,4800,40,FALSE,40,1200,1,1600,120,High,0.04,4800,192000
Ice Cream & Desserts,"The Whole Truth - Nuts, Fruits & Seeds Muesli",32500,20,6,26000,350,FALSE,350,6500,1,122500,74.29,High,0.35,26000,9100000
Ice Cream & Desserts,Pantai Green Curry Paste,15000,14,5,12800,114,FALSE,114,2200,1,12996,112.28,High,0.114,12800,1459200
Ice Cream & Desserts,Kelloggs Special K,21000,8,5,19200,435,FALSE,435,1800,1,189225,44.14,High,0.435,19200,8352000
Ice Cream & Desserts,Moi Soi Sichuan Chilli Oil- For Stir Fry Marinade Spread & Dip,28000,50,5,14000,175,FALSE,175,14000,1,30625,80,High,0.175,14000,2450000
Ice Cream & Desserts,Mother's Recipe Madras Appalam,5000,10,6,4500,100,FALSE,100,500,1,10000,45,High,0.1,4500,450000
Ice Cream & Desserts,Top Ramen Masala Oat Masala,8000,10,6,7200,280,FALSE,280,800,1,78400,25.71,High,0.28,7200,2016000
Ice Cream & Desserts,Saffola Everyday Peppy Tomato Masala Oats,19500,12,6,17100,500,FALSE,500,2400,1,250000,34.2,High,0.5,17100,8550000
Ice Cream & Desserts,"Ching's Secret Instant Noodles, Hot Garlic",6000,0,4,6000,240,FALSE,240,0,1,57600,25,High,0.24,6000,1440000
Ice Cream & Desserts,Kitchens Of India Chicken Chettinad,20000,30,1,14000,285,FALSE,285,6000,1,81225,49.12,High,0.285,14000,3990000
Ice Cream & Desserts,Nestle Cerelac Wheat - Stage 1,19000,0,6,19000,300,FALSE,300,0,1,90000,63.33,High,0.3,19000,5700000
Ice Cream & Desserts,Sumeru Aloo Paratha,11900,5,6,11300,400,FALSE,400,600,1,160000,28.25,High,0.4,11300,4520000
Ice Cream & Desserts,ITC Master Chef Veggie Pizza Pocket,17000,4,4,16200,340,FALSE,340,800,1,115600,47.65,High,0.34,16200,5508000
Ice Cream & Desserts,Wingreens Farms Tangy Cheese Pita Chips & Mexican Salsa Dip,6000,15,1,5100,70,FALSE,70,900,1,4900,72.86,High,0.07,5100,357000
Ice Cream & Desserts,Ching's Secret Manchow Soup,5500,0,3,5500,55,FALSE,55,0,1,3025,100,High,0.055,5500,302500
Ice Cream & Desserts,Veeba Carrot & Cucumber Sandwich Spread,8500,10,6,7600,250,FALSE,250,900,1,62500,30.4,High,0.25,7600,1900000
Ice Cream & Desserts,Kellogg's Real Almond & Honey Corn Flakes,37000,12,3,32400,650,FALSE,650,4600,1,422500,49.85,High,0.65,32400,21060000
Ice Cream & Desserts,Kitchens Of India Mughlai Paneer,16000,30,4,11200,285,FALSE,285,4800,1,81225,39.3,High,0.285,11200,3192000
Ice Cream & Desserts,Ching's Secret Just Soak - Veg Hakka Noodles,3000,0,5,3000,150,FALSE,150,0,1,22500,20,Medium,0.15,3000,450000
Ice Cream & Desserts,Ching's Secret Chowmein Hakka Noodles Masala,6000,10,2,5400,100,FALSE,100,600,1,10000,54,High,0.1,5400,540000
Ice Cream & Desserts,The Whole Truth Dark Chocolate Peanut Butter - Crunchy,23500,20,5,18800,325,FALSE,325,4700,1,105625,57.85,High,0.325,18800,6110000
Ice Cream & Desserts,Mother's Recipe Bhel Puri Chutney,5500,9,4,5000,200,FALSE,200,500,1,40000,25,High,0.2,5000,1000000
Ice Cream & Desserts,Kelloggs Chocos Moon & Stars,33000,10,6,29400,680,FALSE,680,3600,1,462400,43.24,High,0.68,29400,19992000
Ice Cream & Desserts,Mother's Recipe Lime Pickle ,12000,5,1,11400,400,FALSE,400,600,1,160000,28.5,High,0.4,11400,4560000
Ice Cream & Desserts,Kitchens of India Dal Makhani,11000,30,2,7700,285,FALSE,285,3300,1,81225,27.02,High,0.285,7700,2194500
Ice Cream & Desserts,Pantai Light Soy Sauce,27500,14,5,23400,200,FALSE,200,4100,1,40000,117,High,0.2,23400,4680000
Ice Cream & Desserts,Ching's Secret Sweet Corn Soup,5500,0,6,5500,55,FALSE,55,0,1,3025,100,High,0.055,5500,302500
Ice Cream & Desserts,"Top Ramen Noodles, Atta",8000,0,1,8000,280,FALSE,280,0,1,78400,28.57,High,0.28,8000,2240000
Ice Cream & Desserts,Cantina Tortilla Dip Sauce Sour Creamy Tex Mex,22500,15,5,19100,190,FALSE,190,3400,1,36100,100.53,High,0.19,19100,3629000
Ice Cream & Desserts,Dabur Hommade - Rajasthan Ki Garlic Chutne,6500,6,6,6100,200,FALSE,200,400,1,40000,30.5,High,0.2,6100,1220000
Ice Cream & Desserts,MTR Seviyan Vermicelli ,4200,0,2,4200,400,FALSE,400,0,0.9,160000,10.5,High,0.4,4200,1680000
Ice Cream & Desserts,Pantai Oyster Sauce,27500,14,4,23400,200,FALSE,200,4100,1,40000,117,High,0.2,23400,4680000
Ice Cream & Desserts,Go Cheese Spread - Four Pepper (Soft & Creamy),9900,5,6,9400,200,FALSE,200,500,1,40000,47,High,0.2,9400,1880000
Ice Cream & Desserts,MTR Ready To Eat Paneer Butter Masala,13500,9,2,12200,300,FALSE,300,1300,1,90000,40.67,High,0.3,12200,3660000
Ice Cream & Desserts,Nestle Lactogen Stage 2 Follow-up Formula Powder,34000,0,2,34000,400,FALSE,400,0,1,160000,85,High,0.4,34000,13600000
Ice Cream & Desserts,Kellogg's Crunchy Bites Chocos,19000,10,6,17100,375,FALSE,375,1900,1,140625,45.6,High,0.375,17100,6412500
Ice Cream & Desserts,Veeba Hot Sweet Tomato Chilli Sauce,10400,20,3,8300,500,FALSE,500,2100,1,250000,16.6,High,0.5,8300,4150000
Ice Cream & Desserts,Borges Durum Wheat Pasta Superior Quality,25000,40,6,14900,500,FALSE,500,10100,1,250000,29.8,High,0.5,14900,7450000
Ice Cream & Desserts,Funfoods Peanut Butter Crunchy,16900,7,1,15600,400,FALSE,400,1300,1,160000,39,High,0.4,15600,6240000
Ice Cream & Desserts,Pantai Red Curry Paste,6000,0,4,6000,50,FALSE,50,0,1,2500,120,High,0.05,6000,300000
Ice Cream & Desserts,ITC Master Chef Chicken Seekh Kabab,32500,0,6,32500,500,FALSE,500,0,1,250000,65,High,0.5,32500,16250000
Ice Cream & Desserts,Del Monte Pizza & Pasta Sauce Spout Pack,9900,0,3,9900,400,FALSE,400,0,1,160000,24.75,High,0.4,9900,3960000
Ice Cream & Desserts,Pantai Sriracha Red Chilli Sauce,22500,15,6,19100,200,FALSE,200,3400,1,40000,95.5,High,0.2,19100,3820000
Ice Cream & Desserts,Hershey's Cocoa Spread,29500,0,3,29500,350,FALSE,350,0,1,122500,84.29,High,0.35,29500,10325000
Ice Cream & Desserts,Maggi Ghee Tadka Upma Express Pouch,2500,0,6,2500,65,FALSE,65,0,1,4225,38.46,Medium,0.065,2500,162500
Ice Cream & Desserts,Ching's Secret Manchurian Noodles,9100,0,5,9100,360,FALSE,360,0,1,129600,25.28,High,0.36,9100,3276000
Ice Cream & Desserts,Kellogg's All Bran Wheat Flakes,22000,6,5,20500,425,FALSE,425,1500,1,180625,48.24,High,0.425,20500,8712500
Ice Cream & Desserts,Yummiez Chicken Breakfast Sausages,15000,0,3,15000,250,FALSE,250,0,1,62500,60,High,0.25,15000,3750000
Ice Cream & Desserts,Pantai Red Curry Paste,15000,14,3,12800,114,FALSE,114,2200,1,12996,112.28,High,0.114,12800,1459200
Ice Cream & Desserts,Bagrrys Muesli Crunchy Fruit & Nut With Cranberries,33000,10,6,29700,400,FALSE,400,3300,1,160000,74.25,High,0.4,29700,11880000
Ice Cream & Desserts,Quaker Oats Pouch,27600,10,6,24800,1500,FALSE,1,2800,0.9,1500,16.53,High,1.5,24800,24800
Ice Cream & Desserts,Prasuma Momos -  Cheesy Spicy Veg,29500,0,6,29500,24,FALSE,24,0,1,576,1229.17,High,0.024,29500,708000
Ice Cream & Desserts,Veeba Sriracha Chilli Garlic Sauce,14900,8,5,13700,320,FALSE,320,1200,1,102400,42.81,High,0.32,13700,4384000
Ice Cream & Desserts,Ching's Secret Just Soak - Veg Hakka Noodles,11500,0,6,11500,600,FALSE,600,0,0.9,360000,19.17,High,0.6,11500,6900000
Ice Cream & Desserts,Moi Soi Kung Pao Sauce - For Stir Fry Marinade Spread & Dip,28000,50,5,14000,175,FALSE,175,14000,1,30625,80,High,0.175,14000,2450000
Ice Cream & Desserts,Figaro Plain Green Olive ,17900,0,6,17900,450,FALSE,450,0,1,202500,39.78,High,0.45,17900,8055000
Ice Cream & Desserts,Mother's Recipe Gujrati Gorkeri Pickle,14000,10,3,12600,500,FALSE,500,1400,1,250000,25.2,High,0.5,12600,6300000
Ice Cream & Desserts,Kellogg's Muesli 20% Nuts Delight,32000,0,6,32000,500,FALSE,500,0,1,250000,64,High,0.5,32000,16000000
Ice Cream & Desserts,Borges Farfalle Durum Wheat Pasta ,25000,0,5,25000,500,FALSE,500,0,1,250000,50,High,0.5,25000,12500000
Ice Cream & Desserts,Kellogg's Chocos,29900,10,4,26900,700,FALSE,700,3000,1,490000,38.43,High,0.7,26900,18830000
Ice Cream & Desserts,Nestle Nan Pro 4 Follow Up Formula Powder For Older Infants ,62000,0,1,62000,400,FALSE,400,0,1,160000,155,High,0.4,62000,24800000
Ice Cream & Desserts,Veeba Truly Tomato Ketchup,9900,20,6,7900,500,FALSE,500,2000,0.9,250000,15.8,High,0.5,7900,3950000
Ice Cream & Desserts,Ching's Secret Green Chilli Sauce,8500,4,1,8100,680,FALSE,680,400,0.9,462400,11.91,High,0.68,8100,5508000
Ice Cream & Desserts,MTR Roasted Vermicelli ,5500,0,1,5500,400,FALSE,400,0,0.9,160000,13.75,High,0.4,5500,2200000
Ice Cream & Desserts,Mother's Recipe Punjabi Teekha Mang Pickle,12000,10,4,10800,400,FALSE,400,1200,1,160000,27,High,0.4,10800,4320000
Ice Cream & Desserts,Ching's Secret Hot Garlic Instant Noodles,11400,0,6,11400,480,FALSE,480,0,1,230400,23.75,High,0.48,11400,5472000
Ice Cream & Desserts,Kellogg's Real Honey Corn Flakes,29000,7,5,26700,630,FALSE,630,2300,1,396900,42.38,High,0.63,26700,16821000
Ice Cream & Desserts,ITC Master Chef Lebanese Falafel Kebab,13000,4,4,12400,230,FALSE,230,600,1,52900,53.91,High,0.23,12400,2852000
Ice Cream & Desserts,Kelloggs Chocos Fills Double Chocolaty,18500,10,5,16500,250,FALSE,250,2000,1,62500,66,High,0.25,16500,4125000
Ice Cream & Desserts,Organic India Apple Cider Vinegar,59500,9,2,53600,500,FALSE,500,5900,1,250000,107.2,High,0.5,53600,26800000
Ice Cream & Desserts,Masala Oats Masala & Coriander ,19500,9,5,17600,500,FALSE,500,1900,1,250000,35.2,High,0.5,17600,8800000
Ice Cream & Desserts,Ching's Secret  Noodles - Pad Thai Lemongras,20000,0,5,20000,130,FALSE,130,0,1,16900,153.85,High,0.13,20000,2600000
Ice Cream & Desserts,Bagrrys Fruit and Nut Muesli with Cranberries,49900,0,5,49900,750,FALSE,750,0,1,562500,66.53,High,0.75,49900,37425000
Ice Cream & Desserts,Kitchens Of India Yellow Dal Tadka,11000,30,6,7700,285,FALSE,285,3300,1,81225,27.02,High,0.285,7700,2194500
Ice Cream & Desserts,Soulfull Vanilla Fills - Ragi Bites,16900,5,6,16000,250,FALSE,250,900,1,62500,64,High,0.25,16000,4000000
Ice Cream & Desserts,Pantai Teriyaki Sauce with Garlic,32500,15,6,27600,200,FALSE,200,4900,1,40000,138,High,0.2,27600,5520000
Ice Cream & Desserts,Whiskas Adult Pocket Tuna Cat Food,41000,0,1,41000,1200,FALSE,1,0,1,1200,34.17,High,1.2,41000,41000
Ice Cream & Desserts,Kitchens Of India Chicken Darbari ,20000,30,4,14000,285,FALSE,285,6000,1,81225,49.12,High,0.285,14000,3990000
Ice Cream & Desserts,Soulfull Millet Muesli Fruit & Nut Almonds & Real Fruits,29900,10,6,26900,400,FALSE,400,3000,1,160000,67.25,High,0.4,26900,10760000
Ice Cream & Desserts,Smith & Jones Red Pasta Sauce Mix,4000,0,6,4000,46,FALSE,46,0,1,2116,86.96,High,0.046,4000,184000
Ice Cream & Desserts,Kellogg's Muesli Nuts Delight,42500,9,3,38300,750,FALSE,750,4200,1,562500,51.07,High,0.75,38300,28725000
Ice Cream & Desserts,Kitchens of India Dal Bukhara Gravy Mix,11000,30,6,7700,285,FALSE,285,3300,1,81225,27.02,High,0.285,7700,2194500
Ice Cream & Desserts,The Whole Truth Peanut Butter - Sweetened & Crunchy,21500,20,6,17200,325,FALSE,325,4300,1,105625,52.92,High,0.325,17200,5590000
Ice Cream & Desserts,Remia Mayonnaise,23000,0,6,23000,241,FALSE,241,0,1,58081,95.44,High,0.241,23000,5543000
Ice Cream & Desserts,Ching's Secret Green Chilli Sauce,10500,0,6,10500,425,FALSE,425,0,1,180625,24.71,High,0.425,10500,4462500
Ice Cream & Desserts,Bagrrys Fruit N Fibre Muesli - Strawberry,59500,0,1,59500,1000,FALSE,1,0,1,1000,59.5,High,1,59500,59500
Ice Cream & Desserts,Ching's Secret Tomato Oats Instant Soup,1500,0,3,1500,20,FALSE,20,0,1,400,75,Low,0.02,1500,30000
Ice Cream & Desserts,Kellogg's Special K Original Corn Flakes,14000,5,1,13300,290,FALSE,290,700,1,84100,45.86,High,0.29,13300,3857000
Ice Cream & Desserts,Moi Soi  Black Bean Sauce - Dip Spread Stir Fry & Marinade,28000,50,5,14000,175,FALSE,175,14000,1,30625,80,High,0.175,14000,2450000
Ice Cream & Desserts,Tong Garden Wasabi Green Peas,17500,4,6,16700,150,FALSE,150,800,1,22500,111.33,High,0.15,16700,2505000
Ice Cream & Desserts,Ching's Secret Red Chilli Sauce,10500,0,4,10500,440,FALSE,440,0,1,193600,23.86,High,0.44,10500,4620000
Ice Cream & Desserts,Ching's Instant Hot and Sour Soup,5500,0,5,5500,55,FALSE,55,0,1,3025,100,High,0.055,5500,302500
Ice Cream & Desserts,Ching's Secret Noodles - Pad Thai Original,20000,0,6,20000,130,FALSE,130,0,1,16900,153.85,High,0.13,20000,2600000
Ice Cream & Desserts,Aashirvaad Instant Meals - Khatta Meetha Pohaa With Millets,5500,30,5,3800,80,FALSE,80,1700,1,6400,47.5,High,0.08,3800,304000
Ice Cream & Desserts,Del Monte Black Sliced Olives,25000,0,1,25000,450,FALSE,450,0,1,202500,55.56,High,0.45,25000,11250000
Ice Cream & Desserts,Kitchens Of India Murgh Methi,22000,30,5,15400,285,FALSE,285,6600,1,81225,54.04,High,0.285,15400,4389000
Ice Cream & Desserts,Nestle Cerelac 5 Grains & Fruits Cereal,28800,0,6,28800,300,FALSE,300,0,1,90000,96,High,0.3,28800,8640000
Ice Cream & Desserts,The Whole Truth - 5 Grain Muesli No Added Sugar,32500,20,6,26000,350,FALSE,350,6500,1,122500,74.29,High,0.35,26000,9100000
Ice Cream & Desserts,Ching's Secret  Pad Thai Noodles Green Curry,20000,0,6,20000,130,FALSE,130,0,1,16900,153.85,High,0.13,20000,2600000
Ice Cream & Desserts,Aashirvaad Suji Halwa With Jaggery,7500,0,6,7500,70,FALSE,70,0,1,4900,107.14,High,0.07,7500,525000
Ice Cream & Desserts,Mother's Recipe Mango Pickle ,12000,0,1,12000,400,FALSE,400,0,1,160000,30,High,0.4,12000,4800000
Ice Cream & Desserts,Ching's Secret Pad Thai Noodles - Extra Hot Thai Chilli,20000,0,6,20000,130,FALSE,130,0,1,16900,153.85,High,0.13,20000,2600000
Ice Cream & Desserts,Kellogg's Special K Original Corn Flakes,39900,11,6,35500,900,FALSE,900,4400,1,810000,39.44,High,0.9,35500,31950000
Ice Cream & Desserts,Knorr Sweet Corn Chicken Soup,5500,0,2,5500,42,FALSE,42,0,1,1764,130.95,High,0.042,5500,231000
Ice Cream & Desserts,Ching's Secret Tomato Soup,5500,0,6,5500,55,FALSE,55,0,1,3025,100,High,0.055,5500,302500
Ice Cream & Desserts,Funfoods Peanut Butter Creamy,16900,0,1,16900,400,FALSE,400,0,1,160000,42.25,High,0.4,16900,6760000
Ice Cream & Desserts,Japanese Choice Udon Noodles,29500,9,6,26600,250,FALSE,250,2900,1,62500,106.4,High,0.25,26600,6650000
Ice Cream & Desserts,Kelloggs Muesli - With 22% Fruit Magic,32000,10,5,28800,500,FALSE,500,3200,1,250000,57.6,High,0.5,28800,14400000
Ice Cream & Desserts,Dabur Hommade - Kalonji Tamatar Ki Chutney,6500,6,6,6100,200,FALSE,200,400,1,40000,30.5,High,0.2,6100,1220000
Ice Cream & Desserts,Kitchens Of India Dal Makhani,11000,30,1,7700,285,FALSE,285,3300,1,81225,27.02,High,0.285,7700,2194500
Ice Cream & Desserts,Aashirvaad Suji Halwa With Jaggery,5500,30,6,3800,80,FALSE,80,1700,1,6400,47.5,High,0.08,3800,304000
Ice Cream & Desserts,Del Monte Green Chili Sauce,5500,0,3,5500,190,FALSE,190,0,1,36100,28.95,High,0.19,5500,1045000
Ice Cream & Desserts,Pedigree Dog Food Adult Chicken & Veg,66000,10,1,59400,3000,FALSE,3,6600,1,9000,19.8,High,3,59400,178200
Ice Cream & Desserts,Kellogg's Original Corn Flakes,18500,5,6,17500,475,FALSE,475,1000,1,225625,36.84,High,0.475,17500,8312500
Ice Cream & Desserts,Pedigree Puppy Dry Dog Food Food Chicken & Milk,69000,6,2,64800,3000,FALSE,3,4200,1,9000,21.6,High,3,64800,194400
Ice Cream & Desserts,Kitchens Of India Rajma Masala,11000,30,5,7700,285,FALSE,285,3300,1,81225,27.02,High,0.285,7700,2194500
Ice Cream & Desserts,Kitchen Of India Ready-To-Eat Pindi Channa,11000,30,2,7700,285,FALSE,285,3300,1,81225,27.02,High,0.285,7700,2194500
Ice Cream & Desserts,Figaro Pitted Black Olive ,17900,0,6,17900,450,FALSE,450,0,1,202500,39.78,High,0.45,17900,8055000
Ice Cream & Desserts,Cantina Tabasco Red Sauce,14000,15,6,11900,60,FALSE,60,2100,1,3600,198.33,High,0.06,11900,714000
Ice Cream & Desserts,Mother's Recipe Pickle - Mixed,14900,26,6,10900,500,FALSE,500,4000,1,250000,21.8,High,0.5,10900,5450000
Ice Cream & Desserts,Nestle Cerelac Baby Cereal with Milk 5 Grains & Vegetables from 18 to 24 Month,27900,0,5,27900,300,FALSE,300,0,1,90000,93,High,0.3,27900,8370000
Ice Cream & Desserts,Mother's Recipe Tamarind Paste,5000,2,2,4900,200,FALSE,200,100,1,40000,24.5,High,0.2,4900,980000
Ice Cream & Desserts,Pedigree Meat Jerky Adult Dog Treat Barbecued Chicken,14000,20,6,11200,80,FALSE,80,2800,1,6400,140,High,0.08,11200,896000
Ice Cream & Desserts,Veeba Peri Peri Sauce,16100,0,6,16100,300,FALSE,300,0,1,90000,53.67,High,0.3,16100,4830000
Ice Cream & Desserts,Pantai Sriracha Yellow Chilli Sauce,22500,15,6,19100,200,FALSE,200,3400,1,40000,95.5,High,0.2,19100,3820000
Ice Cream & Desserts,Praakritik Organic Jumbo Rolled Oats,19000,11,6,16900,500,FALSE,500,2100,1,250000,33.8,High,0.5,16900,8450000
Ice Cream & Desserts,Ching's Secret Just Soak - Whole Wheat Veg Hakka Noodles,12300,0,6,12300,600,FALSE,600,0,1,360000,20.5,High,0.6,12300,7380000
Ice Cream & Desserts,Pantai Spring Roll Sauce,27500,10,6,24500,200,FALSE,200,3000,1,40000,122.5,High,0.2,24500,4900000
Ice Cream & Desserts,MTR Vermicelli Payasam,7500,0,6,7500,180,FALSE,180,0,1,32400,41.67,High,0.18,7500,1350000
Ice Cream & Desserts,Bagrrys Corn Flakes,35000,0,6,35000,880,FALSE,800,0,1,704000,39.77,High,0.88,35000,28000000
Ice Cream & Desserts,MTR Ready To Eat Palak Paneer ,13500,11,6,12000,300,FALSE,300,1500,1,90000,40,High,0.3,12000,3600000
Ice Cream & Desserts,Del Monte Red Chili Sauce,5500,0,5,5500,190,FALSE,190,0,1,36100,28.95,High,0.19,5500,1045000
Ice Cream & Desserts,Kitchens of India Mutter Paneer Mix,12000,30,4,8400,285,FALSE,285,3600,1,81225,29.47,High,0.285,8400,2394000
Ice Cream & Desserts,Pantai Green Curry Paste,6000,6,6,5600,50,FALSE,50,400,1,2500,112,High,0.05,5600,280000
Ice Cream & Desserts,The Laughing Cow Cheese Spread Plain,11000,0,6,11000,180,FALSE,180,0,1,32400,61.11,High,0.18,11000,1980000
Ice Cream & Desserts,MTR Dal Fry,11000,0,5,11000,300,FALSE,300,0,1,90000,36.67,High,0.3,11000,3300000
Ice Cream & Desserts,Pantai Fish Sauce,27500,14,6,23400,200,FALSE,200,4100,1,40000,117,High,0.2,23400,4680000
Ice Cream & Desserts,Cantina Beans Mexican Beans,25000,14,6,21300,410,FALSE,410,3700,1,168100,51.95,High,0.41,21300,8733000
Ice Cream & Desserts,Ching's Secret Manchurian Instant Noodle,11400,0,6,11400,480,FALSE,480,0,1,230400,23.75,High,0.48,11400,5472000
Ice Cream & Desserts,Remia Salad Italian Dressing ,23000,0,6,23000,250,FALSE,250,0,1,62500,92,High,0.25,23000,5750000
Ice Cream & Desserts,Yummiez Veg Cheese Fingers Pouch,23000,0,4,23000,400,FALSE,400,0,1,160000,57.5,High,0.4,23000,9200000
Ice Cream & Desserts,MTR Dal Makhani,11000,0,4,11000,300,FALSE,300,0,1,90000,36.67,High,0.3,11000,3300000
Ice Cream & Desserts,MTR Ready to Eat Pav Bhaji,11000,0,6,11000,300,FALSE,300,0,1,90000,36.67,High,0.3,11000,3300000
Ice Cream & Desserts,Weikfield Tomato Salsa Instant Pasta,2500,0,1,2500,77,FALSE,77,0,1,5929,32.47,Medium,0.077,2500,192500
Ice Cream & Desserts,Nestlé CERELAC Baby Cereal with Milk,27200,0,1,27200,300,FALSE,300,0,1,90000,90.67,High,0.3,27200,8160000
Ice Cream & Desserts,Remia Salad Caesar Dressing,25000,0,6,25000,250,FALSE,250,0,1,62500,100,High,0.25,25000,6250000
Ice Cream & Desserts,Bagrrys Fruit N Fibre Muesli Mixed Fruit,33000,0,6,33000,500,FALSE,500,0,1,250000,66,High,0.5,33000,16500000
Ice Cream & Desserts,MTR Paneer Butter Masala & Veg Pulao,17500,9,4,15800,375,FALSE,375,1700,1,140625,42.13,High,0.375,15800,5925000
Ice Cream & Desserts,Sundrop Cocoa Nut Hazelnut Chocolatey Spread,12000,0,6,12000,160,FALSE,160,0,1,25600,75,High,0.16,12000,1920000
Ice Cream & Desserts,Moi Soi Manchurian Sauce - For Stir Fry Marinade Spread & Dip,28000,50,6,14000,175,FALSE,175,14000,1,30625,80,High,0.175,14000,2450000
Ice Cream & Desserts,Pedigree Dog Food Adult Meat & Rice,66000,7,2,60800,3000,FALSE,3,5200,1,9000,20.27,High,3,60800,182400
Ice Cream & Desserts,Pantai Sriracha Green Chilli Sauce,22500,15,6,19100,200,FALSE,200,3400,1,40000,95.5,High,0.2,19100,3820000
Ice Cream & Desserts,Pantai Chilli Garlic Sauce,27500,14,6,23400,200,FALSE,200,4100,1,40000,117,High,0.2,23400,4680000
Ice Cream & Desserts,Pantai Dark Soy Sauce,27500,14,6,23400,200,FALSE,200,4100,1,40000,117,High,0.2,23400,4680000
Ice Cream & Desserts,Yoga Bar Peanut Butter Dark Chocolate Jar,24900,0,4,24900,400,FALSE,400,0,1,160000,62.25,High,0.4,24900,9960000
Ice Cream & Desserts,Cantina Tabasco Green Sauce,14000,15,6,11900,60,FALSE,60,2100,1,3600,198.33,High,0.06,11900,714000
Ice Cream & Desserts,Pantai Pad Thai Sauce (Non-Veg),32500,9,5,29300,200,FALSE,200,3200,1,40000,146.5,High,0.2,29300,5860000
Ice Cream & Desserts,Pantai Sweet Chilli Sauce,27500,14,6,23400,200,FALSE,200,4100,1,40000,117,High,0.2,23400,4680000
Ice Cream & Desserts,Ching's Secret Schezwan Instant Noodle,11400,0,6,11400,480,FALSE,480,0,1,230400,23.75,High,0.48,11400,5472000
Ice Cream & Desserts,Yummiez Chicken Garlic Fingers Pouch,25000,0,5,25000,400,FALSE,400,0,1,160000,62.5,High,0.4,25000,10000000
Ice Cream & Desserts,Pediasure Premium Chocolate Powdered Health Drink,61000,0,2,61000,400,FALSE,400,0,1,160000,152.5,High,0.4,61000,24400000
Ice Cream & Desserts,Chings Secret Hot Garlic Instant Noodles,9100,0,6,9100,60,FALSE,60,0,1,3600,151.67,High,0.06,9100,546000
Ice Cream & Desserts,Godrej Yummiez Cheese Corn Nuggets ,23000,0,4,23000,400,FALSE,400,0,1,160000,57.5,High,0.4,23000,9200000
Ice Cream & Desserts,Pantai Hot Chilli Sauce,27500,14,6,23400,200,FALSE,200,4100,1,40000,117,High,0.2,23400,4680000
Ice Cream & Desserts,Knorr International Mexican Tomato Corn Soup ,6500,6,3,6100,52,FALSE,52,400,1,2704,117.31,High,0.052,6100,317200
Ice Cream & Desserts,Bagrry's Fruit Fibre Muesli Mixed Fruit ,59500,0,5,59500,1000,FALSE,1,0,1,1000,59.5,High,1,59500,59500
Ice Cream & Desserts,MTR Roasted Vermicelli ,10500,0,4,10500,850,FALSE,850,0,0.9,722500,12.35,High,0.85,10500,8925000
Ice Cream & Desserts,Maggi 2-Minute Instant Noodles - Masala,4400,0,0,4400,280,TRUE,280,0,0.9,78400,15.71,High,0.28,4400,1232000
Ice Cream & Desserts,"Kurkure Green Chutney, Rajasthani Style",2000,0,0,2000,90,TRUE,90,0,1,8100,22.22,Medium,0.09,2000,180000
Ice Cream & Desserts,Kellogg's Chocos Combo Pack,6000,6,0,5600,156,TRUE,156,400,1,24336,35.9,High,0.156,5600,873600
Ice Cream & Desserts,Kissan Mixed Fruit Jam ,15500,0,0,15500,500,TRUE,500,0,1,250000,31,High,0.5,15500,7750000
Ice Cream & Desserts,Lijjat Urad Papad,6000,5,0,5700,200,TRUE,200,300,1,40000,28.5,High,0.2,5700,1140000
Ice Cream & Desserts,Amul Cheese Spread Yummy Plain,8500,0,0,8500,200,TRUE,200,0,1,40000,42.5,High,0.2,8500,1700000
Ice Cream & Desserts,Mother's Recipe Ginger And Garlic Paste,5000,24,0,3800,200,TRUE,200,1200,1,40000,19,High,0.2,3800,760000
Ice Cream & Desserts,Maggi Magic Cubes Chicken,4000,2,0,3900,40,TRUE,40,100,1,1600,97.5,High,0.04,3900,156000
Ice Cream & Desserts,Pedigree Puppy Chicken Chunks in Gravy ,3500,2,0,3400,70,TRUE,70,100,1,4900,48.57,Medium,0.07,3400,238000
Ice Cream & Desserts,The Whole Truth Peanut Butter - Unsweetened & Crunchy,18500,20,0,14800,325,TRUE,325,3700,1,105625,45.54,High,0.325,14800,4810000
Ice Cream & Desserts,Ching's Chow Mein Hakka Noodles Masala,1000,0,0,1000,20,TRUE,20,0,1,400,50,Low,0.02,1000,20000
Ice Cream & Desserts,Safal Frozen Mixed Vegetables,6000,5,0,5700,500,TRUE,500,300,0.9,250000,11.4,High,0.5,5700,2850000
Ice Cream & Desserts,Safal Frozen Corn,4100,4,0,3900,200,TRUE,200,200,1,40000,19.5,High,0.2,3900,780000
Ice Cream & Desserts,Amul Cheese Spread Spicy Garlic,8500,3,0,8200,200,TRUE,200,300,1,40000,41,High,0.2,8200,1640000
Ice Cream & Desserts,Ching's Secret Veg Hakka Noodles,10700,0,0,10700,600,TRUE,600,0,0.9,360000,17.83,High,0.6,10700,6420000
Ice Cream & Desserts,Saffola Oats 100 % Natural,1500,0,0,1500,38,TRUE,38,0,1,1444,39.47,Low,0.038,1500,57000
Ice Cream & Desserts,Lijjat Moong Papad,6000,5,0,5700,200,TRUE,200,300,1,40000,28.5,High,0.2,5700,1140000
Ice Cream & Desserts,Mothers Recipe Papad - Sabudana With Rock Salt,3100,9,0,2800,70,TRUE,70,300,1,4900,40,Medium,0.07,2800,196000
Ice Cream & Desserts,Maggi Chilly Chow Cuppa Noodles,5000,0,0,5000,70,TRUE,70,0,1,4900,71.43,High,0.07,5000,350000
Ice Cream & Desserts,Veeba Favourites Eggless Burger Mayonnaise,6900,8,0,6300,250,TRUE,250,600,1,62500,25.2,High,0.25,6300,1575000
Ice Cream & Desserts,Sunfeast Yippee! Magic Masala Noodles,4800,6,0,4500,240,TRUE,240,300,1,57600,18.75,High,0.24,4500,1080000
Ice Cream & Desserts,Top Ramen Masala,9100,9,0,8200,560,TRUE,560,900,0.9,313600,14.64,High,0.56,8200,4592000
Ice Cream & Desserts,Kelloggs Corn Flakes With Real Strawberry Pure,26500,10,0,23600,575,TRUE,575,2900,1,330625,41.04,High,0.575,23600,13570000
Ice Cream & Desserts,Mother's Recipe Potato Papad,3100,9,0,2800,70,TRUE,75,300,1,5250,40,Medium,0.07,2800,210000
Ice Cream & Desserts,Mothers Recipe Rice Papad Ajwain,2400,0,0,2400,75,TRUE,75,0,1,5625,32,Medium,0.075,2400,180000
Ice Cream & Desserts,Chef's Basket Durum Wheat Penne Pasta,16000,50,0,8000,500,TRUE,500,8000,1,250000,16,High,0.5,8000,4000000
Ice Cream & Desserts,Dabur Hommade - Imli Sauce Saunth,2000,10,0,1800,100,TRUE,100,200,1,10000,18,Medium,0.1,1800,180000
Ice Cream & Desserts,Zorabian Chicken Kheema Parathas,19000,0,0,19000,300,TRUE,300,0,1,90000,63.33,High,0.3,19000,5700000
Ice Cream & Desserts,Sunfeast Pasta Treat Pack of Tomato Cheese,2800,17,0,2300,65,TRUE,65,500,1,4225,35.38,Medium,0.065,2300,149500
Ice Cream & Desserts,Safal Frozen - Sweet Corn,16000,5,0,15200,1000,TRUE,1,800,0.9,1000,15.2,High,1,15200,15200
Ice Cream & Desserts,MTR Vegetable Upma,2500,0,0,2500,60,TRUE,60,0,1,3600,41.67,Medium,0.06,2500,150000
Ice Cream & Desserts,Del Monte Original Blend Tomato Ketchup Pouch,12000,7,0,11100,950,TRUE,950,900,0.9,902500,11.68,High,0.95,11100,10545000
Ice Cream & Desserts,Del Monte Natural Vinegar ,5500,3,0,5300,180,TRUE,180,200,1,32400,29.44,High,0.18,5300,954000
Ice Cream & Desserts,Del Monte Eggless Mayo,13500,6,0,12600,500,TRUE,500,900,1,250000,25.2,High,0.5,12600,6300000
Ice Cream & Desserts,ITC Master Chef Cheesy Corn Triangles,16000,5,0,15200,320,TRUE,320,800,1,102400,47.5,High,0.32,15200,4864000
Ice Cream & Desserts,Mother's Recipe Mixed Pickle ,11500,4,0,11000,400,TRUE,400,500,1,160000,27.5,High,0.4,11000,4400000
Ice Cream & Desserts,Godrej Yummiez Chicken Breakfast Salami,15000,4,0,14300,250,TRUE,250,700,1,62500,57.2,High,0.25,14300,3575000
Ice Cream & Desserts,Hershey's Cocoa + Almond Spread,29500,9,0,26600,350,TRUE,350,2900,1,122500,76,High,0.35,26600,9310000
Ice Cream & Desserts,Maggi Special Masala Spicy Yummy Noodles,7200,0,0,7200,280,TRUE,280,0,1,78400,25.71,High,0.28,7200,2016000
Ice Cream & Desserts,Del Monte Schezwan Sauce,5500,0,0,5500,190,TRUE,190,0,1,36100,28.95,High,0.19,5500,1045000
Ice Cream & Desserts,Yummiez Green Peas,13500,0,0,13500,500,TRUE,500,0,1,250000,27,High,0.5,13500,6750000
Ice Cream & Desserts,Yummiez Green Peas,25000,0,0,25000,1000,TRUE,1,0,1,1000,25,High,1,25000,25000
Ice Cream & Desserts,Yummiez American Sweet Corn,8500,0,0,8500,400,TRUE,400,0,1,160000,21.25,High,0.4,8500,3400000
Ice Cream & Desserts,Dr Oetker Cucumber & Carrot Sandwich Spread Veg,7900,0,0,7900,250,TRUE,250,0,1,62500,31.6,High,0.25,7900,1975000
Ice Cream & Desserts,Del Monte Pitted Green Olives,25000,0,0,25000,450,TRUE,450,0,1,202500,55.56,High,0.45,25000,11250000
Chocolates & Candies,Maggi 2 Minute Masala Noodles,1200,0,6,1200,70,FALSE,70,0,0.9,4900,17.14,Low,0.07,1200,84000
Chocolates & Candies,iD Idli & Dosa Batter ,8000,15,6,6800,1000,FALSE,1,1200,0.9,1000,6.8,High,1,6800,6800
Chocolates & Candies,iD Malabar Parota ,8000,10,4,7200,400,FALSE,400,800,1,160000,18,High,0.4,7200,2880000
Chocolates & Candies,iD Wheat Lachha Paratha,8000,12,6,7000,400,FALSE,400,1000,1,160000,17.5,High,0.4,7000,2800000
Chocolates & Candies,McCain Aloo Tikki,11000,4,6,10500,400,FALSE,400,500,1,160000,26.25,High,0.4,10500,4200000
Chocolates & Candies,McCain Smiles Cripsy Happy Potatoes,12000,5,6,11400,415,FALSE,415,600,1,172225,27.47,High,0.415,11400,4731000
Chocolates & Candies,McCain Veggie Burger Patty,11500,3,6,11100,360,FALSE,360,400,1,129600,30.83,High,0.36,11100,3996000
Chocolates & Candies,McCain Veggie Fingers,11700,5,6,11100,400,FALSE,400,600,1,160000,27.75,High,0.4,11100,4440000
Chocolates & Candies,Amul Delicious Fat Spread - Cholesterol Free,1800,5,6,1700,100,FALSE,100,100,0.9,10000,17,Low,0.1,1700,170000
Chocolates & Candies,Whiskas Wet  Meal (Adult - Cat Food)  Chicken in Gravy,3500,2,2,3400,85,FALSE,85,100,1,7225,40,Medium,0.085,3400,289000
Chocolates & Candies,McCain Chilli Garlic Potato Bites Crunchy Potato Nuggets,12500,5,1,11800,420,FALSE,420,700,1,176400,28.1,High,0.42,11800,4956000
Chocolates & Candies,Ching's Secret Instant Hot Garlic Noodles,1500,0,3,1500,60,FALSE,60,0,1,3600,25,Low,0.06,1500,90000
Chocolates & Candies,Veeba Eggless Mayonnaise,7900,11,5,7000,250,FALSE,250,900,1,62500,28,High,0.25,7000,1750000
Chocolates & Candies,Ching's Secret Instant Schezwan Noodles,1500,0,6,1500,60,FALSE,60,0,1,3600,25,Low,0.06,1500,90000
Chocolates & Candies,Veeba Pasta And Pizza Sauce,7500,13,5,6500,280,FALSE,280,1000,1,78400,23.21,High,0.28,6500,1820000
Chocolates & Candies,Top Ramen  Noodles Curry Veg Pouch,2000,0,1,2000,70,FALSE,70,0,1,4900,28.57,Medium,0.07,2000,140000
Chocolates & Candies,Saffola Veggie Twist Masala Oats,1500,0,6,1500,38,FALSE,38,0,1,1444,39.47,Low,0.038,1500,57000
Chocolates & Candies,Unibic Almond & Oats Protein Bar,4000,17,4,3300,30,FALSE,30,700,1,900,110,High,0.03,3300,99000
Chocolates & Candies,Quaker Oats,7900,0,2,7900,400,FALSE,400,0,0.9,160000,19.75,High,0.4,7900,3160000
Chocolates & Candies,Amul Delicious Fat Spread - Cholesterol Free,8800,2,2,8600,500,FALSE,500,200,0.9,250000,17.2,High,0.5,8600,4300000
Chocolates & Candies,McCain French Fries,12000,5,1,11400,420,FALSE,420,600,1,176400,27.14,High,0.42,11400,4788000
Chocolates & Candies,Ching's Secret Manchow Instant Soup,1000,0,1,1000,15,FALSE,15,0,1,225,66.67,Low,0.015,1000,15000
Chocolates & Candies,McCain Potato Cheese Shotz,13000,4,6,12400,250,FALSE,250,600,1,62500,49.6,High,0.25,12400,3100000
Chocolates & Candies,McCain Masala - Fries,12000,5,3,11400,375,FALSE,375,600,1,140625,30.4,High,0.375,11400,4275000
Chocolates & Candies,Ching's Secret Schezwan Fried Rice Masala,1500,0,6,1500,20,FALSE,20,0,1,400,75,Low,0.02,1500,30000
Chocolates & Candies,McCain New Mini Samosa with Cheese Pizza Style Filling,12000,1,3,11800,240,FALSE,240,200,1,57600,49.17,High,0.24,11800,2832000
Chocolates & Candies,McCain Chilli Cheesy Nuggets,13000,4,1,12400,250,FALSE,250,600,1,62500,49.6,High,0.25,12400,3100000
Chocolates & Candies,"Whiskas Adult (+1 Year) Dry Cat Food, Ocean Fish Flavour",43000,10,6,38700,1200,FALSE,1,4300,1,1200,32.25,High,1.2,38700,38700
Chocolates & Candies,Chings Instant Soup - Hot & Sour,1000,0,1,1000,15,FALSE,15,0,1,225,66.67,Low,0.015,1000,15000
Chocolates & Candies,Amul Spray Infant Milk Food,19700,2,6,19300,500,FALSE,500,400,1,250000,38.6,High,0.5,19300,9650000
Chocolates & Candies,McCain Smiles - Pudina Chatka,12000,5,3,11400,375,FALSE,375,600,1,140625,30.4,High,0.375,11400,4275000
Chocolates & Candies,McCain French Fries Crisp & Delicious,17500,4,3,16700,750,FALSE,750,800,1,562500,22.27,High,0.75,16700,12525000
Chocolates & Candies,Ferrero Nutella Hazelnut Spread,22000,5,2,20700,180,FALSE,180,1300,1,32400,115,High,0.18,20700,3726000
Chocolates & Candies,Lijjat Garlic Papad,6000,5,5,5700,200,FALSE,200,300,1,40000,28.5,High,0.2,5700,1140000
Chocolates & Candies,Switz Samosa Dough Sheets,9000,4,6,8600,50,FALSE,50,400,1,2500,172,High,0.05,8600,430000
Chocolates & Candies,Amul Cheese Spread Creamy,8500,5,6,8000,180,FALSE,180,500,1,32400,44.44,High,0.18,8000,1440000
Chocolates & Candies,Maggi Imli Sauce Pichkoo,2200,0,6,2200,90,FALSE,90,0,1,8100,24.44,Medium,0.09,2200,198000
Chocolates & Candies,Whiskas Kitten (2-12 months) Dry Cat Food Food Ocean Fish,38500,9,5,34700,1100,FALSE,1100,3800,1,1210000,31.55,High,1.1,34700,38170000
Chocolates & Candies,Chings Instant Soup - Sweet Corn Veg,1000,0,2,1000,15,FALSE,15,0,1,225,66.67,Low,0.015,1000,15000
Chocolates & Candies,Whiskas Wet  Meal (Kitten - Cat Food)  Chicken in Gravy,3500,5,2,3300,85,FALSE,85,200,1,7225,38.82,Medium,0.085,3300,280500
Chocolates & Candies,McCain Crazy Fries Masala MixHot 'n' Tangy,12000,5,6,11400,400,FALSE,400,600,1,160000,28.5,High,0.4,11400,4560000
Chocolates & Candies,The Whole Truth Double Cocoa Protein Bar No Sugar,10000,10,6,9000,52,FALSE,52,1000,1,2704,173.08,High,0.052,9000,468000
Chocolates & Candies,Amul Happy Treats French Fries,6800,4,1,6500,425,FALSE,425,300,0.9,180625,15.29,High,0.425,6500,2762500
Chocolates & Candies,Ferrero Nutella Hazeulnut Spread,38000,6,5,35700,350,FALSE,350,2300,1,122500,102,High,0.35,35700,12495000
Chocolates & Candies,Veeba Chipolte Southwest Dressing,16100,7,4,14900,300,FALSE,300,1200,1,90000,49.67,High,0.3,14900,4470000
Chocolates & Candies,Ching's Secret Manchow Noodles Instant Soup,1500,0,6,1500,20,FALSE,20,0,1,400,75,Low,0.02,1500,30000
Chocolates & Candies,Yoga Bar Breakfast Protein Bar - Blueberry Pie,5000,12,1,4400,50,FALSE,50,600,1,2500,88,High,0.05,4400,220000
Chocolates & Candies,Quaker Oats,19900,7,6,18400,1000,FALSE,1,1500,0.9,1000,18.4,High,1,18400,18400
Chocolates & Candies,The Whole Truth Mini Protein Bar - Coconut Cocoa No Added Sugar,5500,25,6,4100,27,FALSE,27,1400,1,729,151.85,High,0.027,4100,110700
Chocolates & Candies,Switz Spring Roll Dough Sheets,9000,4,6,8600,1160,FALSE,20,400,0.9,23200,7.41,High,1.16,8600,172000
Chocolates & Candies,Unibic Fruit & Nut Real Cranberries & Almonds Protein Bar,4000,17,6,3300,30,FALSE,30,700,1,900,110,High,0.03,3300,99000
Chocolates & Candies,Ching's Secret Tomato Instant Soup,1000,0,1,1000,16,FALSE,15,0,1,240,62.5,Low,0.016,1000,15000
Chocolates & Candies,Chef's Basket Durum Wheat Elbow Pasta,16000,50,6,8000,500,FALSE,500,8000,1,250000,16,High,0.5,8000,4000000
Chocolates & Candies,Sunfeast Yippee! Mood Masala Noodles,6000,28,3,4300,260,FALSE,260,1700,1,67600,16.54,High,0.26,4300,1118000
Chocolates & Candies,MTR Breakfast Khatta Meetha Poha Mix,2500,20,6,2000,60,FALSE,60,500,1,3600,33.33,Medium,0.06,2000,120000
Chocolates & Candies,Kellogg's Crunchy Fruit & Nut Breakfast Cereals Muesli,44500,9,6,40100,750,FALSE,750,4400,1,562500,53.47,High,0.75,40100,30075000
Chocolates & Candies,Ching's Secret Chilli Vinegar,5000,0,4,5000,170,FALSE,170,0,1,28900,29.41,High,0.17,5000,850000
Chocolates & Candies,Ching's Red Chilli Sauce,5500,0,6,5500,200,FALSE,200,0,1,40000,27.5,High,0.2,5500,1100000
Chocolates & Candies,Amul Lite Spread,4000,2,5,3900,100,FALSE,100,100,1,10000,39,High,0.1,3900,390000
Chocolates & Candies,Borges Durum Wheat Fusilli Pasta ,25000,0,3,25000,500,FALSE,500,0,1,250000,50,High,0.5,25000,12500000
Chocolates & Candies,The Whole Truth Cranberry Mini Protein Bar No Sugar,5500,20,6,4400,27,FALSE,27,1100,1,729,162.96,High,0.027,4400,118800
Chocolates & Candies,The Whole Truth Mini Protein Bar - Coffee Cocoa No Added Sugar,5500,20,6,4400,27,FALSE,27,1100,1,729,162.96,High,0.027,4400,118800
Chocolates & Candies,Maggi Hot & Sweet Tomato Chilli Sauce,11500,0,1,11500,500,FALSE,500,0,1,250000,23,High,0.5,11500,5750000
Chocolates & Candies,Sunfeast YiPPee! Noodles - Magic Masala,9600,5,4,9100,540,FALSE,540,500,0.9,291600,16.85,High,0.54,9100,4914000
Chocolates & Candies,Chef's Basket Durum Wheat Fusilli Pasta,16000,50,6,8000,500,FALSE,500,8000,1,250000,16,High,0.5,8000,4000000
Chocolates & Candies,Top Ramen Chicken Noodles,6000,10,1,5400,280,FALSE,280,600,1,78400,19.29,High,0.28,5400,1512000
Chocolates & Candies,Veeba Cheese and Chilli Sandwich Spread,8900,11,6,7900,275,FALSE,275,1000,1,75625,28.73,High,0.275,7900,2172500
Chocolates & Candies,Chings Secret Chowmein Hakka Noodles Masala ,4400,0,2,4400,60,FALSE,60,0,1,3600,73.33,High,0.06,4400,264000
Chocolates & Candies,Safal Frozen - Mixed Vegetables,11000,4,2,10500,1000,FALSE,1,500,0.9,1000,10.5,High,1,10500,10500
Chocolates & Candies,MTR 3 Min Poha,2500,0,6,2500,60,FALSE,60,0,1,3600,41.67,Medium,0.06,2500,150000
Chocolates & Candies,Ching's Manchurian Instant Noodles,1500,0,5,1500,60,FALSE,60,0,1,3600,25,Low,0.06,1500,90000
Chocolates & Candies,The Whole Truth Peanut Cocoa Mini Protein Bar No Sugar ,5500,25,6,4100,27,FALSE,27,1400,1,729,151.85,High,0.027,4100,110700
Chocolates & Candies,Gits Pav Bhaji Ready to Eat,11000,22,6,8500,300,FALSE,300,2500,1,90000,28.33,High,0.3,8500,2550000
Chocolates & Candies,McCain New Mini Samosa with Cheese Corn Style Filling,12000,1,2,11800,240,FALSE,240,200,1,57600,49.17,High,0.24,11800,2832000
Chocolates & Candies,Lijjat Udad Mini Papad,6000,6,6,5600,200,FALSE,200,400,1,40000,28,High,0.2,5600,1120000
Chocolates & Candies,McCain Herb & Garlic Crazy Fries Masala Mix ,12000,5,5,11400,400,FALSE,400,600,1,160000,28.5,High,0.4,11400,4560000
Chocolates & Candies,Yoga Bar Multigrain Energy Bar Nuts And Seeds,4000,12,4,3500,38,FALSE,38,500,1,1444,92.11,High,0.038,3500,133000
Chocolates & Candies,"Ching's Secret Sauce, Green Chilli",5500,0,5,5500,190,FALSE,190,0,1,36100,28.95,High,0.19,5500,1045000
Chocolates & Candies,Veeba Pizza Topping,7500,6,4,7000,280,FALSE,280,500,1,78400,25,High,0.28,7000,1960000
Chocolates & Candies,Switz Paratha Puff,11000,4,6,10500,400,FALSE,400,500,1,160000,26.25,High,0.4,10500,4200000
Chocolates & Candies,"New Kellogg's Muesli with 21% Fruit, Nut & Seeds",32500,6,6,30500,500,FALSE,500,2000,1,250000,61,High,0.5,30500,15250000
Chocolates & Candies,The Whole Truth Double Cocoa Mini Protein Bar No Sugar,5500,20,5,4400,27,FALSE,27,1100,1,729,162.96,High,0.027,4400,118800
Chocolates & Candies,Sunfeast Yippee Tricolor Pasta Seasoning,2800,17,1,2300,65,FALSE,65,500,1,4225,35.38,Medium,0.065,2300,149500
Chocolates & Candies,Wingreens Cheesy Chipotle Sauce,9900,49,1,5000,130,FALSE,130,4900,1,16900,38.46,High,0.13,5000,650000
Chocolates & Candies,Maggi Rich Tomato Ketchup,10500,4,2,10000,500,FALSE,500,500,1,250000,20,High,0.5,10000,5000000
Chocolates & Candies,The Whole Truth Dark Chocolate Peanut Butter - Creamy,23500,25,6,17400,325,FALSE,325,6100,1,105625,53.54,High,0.325,17400,5655000
Chocolates & Candies,Godrej Yummiez Chicken Nuggets,32500,9,1,29300,500,FALSE,500,3200,1,250000,58.6,High,0.5,29300,14650000
Chocolates & Candies,Go Cheese  Spread Plain,9900,5,6,9400,200,FALSE,200,500,1,40000,47,High,0.2,9400,1880000
Chocolates & Candies,Kellogg's Real Almond & Honey Corn Flakes,17500,9,6,15800,300,FALSE,300,1700,1,90000,52.67,High,0.3,15800,4740000
Chocolates & Candies,The Whole Truth Vegan Almond Choco Fudge Energy Bar No Sugar,6000,20,6,4800,40,FALSE,40,1200,1,1600,120,High,0.04,4800,192000
Chocolates & Candies,Prasuma Vegetable Momos,27000,0,5,27000,24,FALSE,24,0,1,576,1125,High,0.024,27000,648000
Chocolates & Candies,MTR Upma,5000,10,6,4500,160,FALSE,160,500,1,25600,28.13,High,0.16,4500,720000
Chocolates & Candies,Ching's Schezwan Masala Instant Noodles,6000,0,1,6000,240,FALSE,240,0,1,57600,25,High,0.24,6000,1440000
Chocolates & Candies,The Whole Truth Cranberry Protein Bar No Sugar,10000,26,6,7400,52,FALSE,52,2600,1,2704,142.31,High,0.052,7400,384800
Chocolates & Candies,Saffola Yummy Masala Noodles ,2000,0,2,2000,46,FALSE,46,0,1,2116,43.48,Medium,0.046,2000,92000
Chocolates & Candies,Veeba English Mustard,7400,6,2,6900,300,FALSE,300,500,1,90000,23,High,0.3,6900,2070000
Chocolates & Candies,Dabur Hommade Tamarind Paste,4800,6,6,4500,200,FALSE,200,300,1,40000,22.5,High,0.2,4500,900000
Chocolates & Candies,Yoga Bar Breakfast Muesli - Almond Caramel (No Added Sugar),32500,4,6,30900,400,FALSE,400,1600,1,160000,77.25,High,0.4,30900,12360000
Chocolates & Candies,The Whole Truth Mini Protein Bar - Peanut Butter No Added Sugar,5500,25,6,4100,27,FALSE,27,1400,1,729,151.85,High,0.027,4100,110700
Chocolates & Candies,ITC Master Chef Crispy Chicken Fries ,17000,4,3,16200,280,FALSE,280,800,1,78400,57.86,High,0.28,16200,4536000
Chocolates & Candies,Kelloggs Corn Flakes,9900,13,6,8600,250,FALSE,250,1300,1,62500,34.4,High,0.25,8600,2150000
Chocolates & Candies,Nissin Cup Noodles Tangy Tomato,5000,10,2,4500,70,FALSE,70,500,1,4900,64.29,High,0.07,4500,315000
Chocolates & Candies,Smith & Jones White Pasta Sauce Mix,4000,0,3,4000,46,FALSE,46,0,1,2116,86.96,High,0.046,4000,184000
Chocolates & Candies,Sunfeast Yippee! Pasta Treat - Sour Cream Onion,2800,10,1,2500,65,FALSE,65,300,1,4225,38.46,Medium,0.065,2500,162500
Chocolates & Candies,Mothers Recipe Tamrind Date Chutney ,5500,9,2,5000,200,FALSE,200,500,1,40000,25,High,0.2,5000,1000000
Chocolates & Candies,Veeba Mint Mayonnaise,16900,8,4,15500,300,FALSE,300,1400,1,90000,51.67,High,0.3,15500,4650000
Chocolates & Candies,Mccain Emotibites - Crispy Happy Potato Snack,13000,0,6,12900,415,FALSE,415,100,1,172225,31.08,High,0.415,12900,5353500
Chocolates & Candies,The Whole Truth Energy Bar Choco Cranberry Fudge,6000,26,6,4400,40,FALSE,40,1600,1,1600,110,High,0.04,4400,176000
Chocolates & Candies,Godrej Yummiez Chicken Lucknowi Seekh Kebab,26000,10,4,23400,400,FALSE,400,2600,1,160000,58.5,High,0.4,23400,9360000
Chocolates & Candies,Prasuma Vegetable Momos,15000,0,5,15000,580,FALSE,10,0,1,5800,25.86,High,0.58,15000,150000
Chocolates & Candies,Mother's Recipe Mixed Pickle,8500,9,2,7700,300,FALSE,300,800,1,90000,25.67,High,0.3,7700,2310000
Chocolates & Candies,Sunfeast Yippee! Pasta Treat - Sour Cream Onion,2800,17,3,2300,65,FALSE,65,500,1,4225,35.38,Medium,0.065,2300,149500
Chocolates & Candies,The Whole Truth Peanut Cocoa Protein Bar No Sugar,10000,26,6,7400,52,FALSE,52,2600,1,2704,142.31,High,0.052,7400,384800
Chocolates & Candies,Yoga Bar Breakfast Muesli - Chocolate & Cranberry ,32500,4,6,30900,400,FALSE,400,1600,1,160000,77.25,High,0.4,30900,12360000
Chocolates & Candies,Sunfeast YiPPee! Magic Masala Noodles,7000,10,3,6300,405,FALSE,405,700,0.9,164025,15.56,High,0.405,6300,2551500
Chocolates & Candies,Veeba Sweet Onion Sauce,14100,14,4,12100,350,FALSE,350,2000,1,122500,34.57,High,0.35,12100,4235000
Chocolates & Candies,Quaker Oats Breakfast Cereals - With Flavour Mix Nutritious Rich Source Of Energy,4900,8,6,4500,200,FALSE,200,400,1,40000,22.5,High,0.2,4500,900000
Chocolates & Candies,Mother's Recipe Tamarind Paste,5000,2,6,4900,200,FALSE,200,100,1,40000,24.5,High,0.2,4900,980000
Chocolates & Candies,Yogabar No Added Sugar Protein Bar Brownie,12500,15,4,10600,60,FALSE,60,1900,1,3600,176.67,High,0.06,10600,636000
Chocolates & Candies,Bambino Popular Vermicelli ,4000,2,3,3900,400,FALSE,400,100,0.9,160000,9.75,High,0.4,3900,1560000
Chocolates & Candies,Ching's Secret Mix Veg Instant Soup,1000,0,3,1000,15,FALSE,15,0,1,225,66.67,Low,0.015,1000,15000
Chocolates & Candies,Mother's Recipe Pickle - Red Stuffed Chilli,14500,11,3,12900,400,FALSE,400,1600,1,160000,32.25,High,0.4,12900,5160000
Chocolates & Candies,Kellogg's No Added Sugar Muesli,33500,11,6,29800,500,FALSE,500,3700,1,250000,59.6,High,0.5,29800,14900000
Chocolates & Candies,Veeba Salsa Dip,11900,6,6,11100,360,FALSE,360,800,1,129600,30.83,High,0.36,11100,3996000
Chocolates & Candies,Veeba Thousand Island Dressing,14900,8,6,13700,300,FALSE,300,1200,1,90000,45.67,High,0.3,13700,4110000
Chocolates & Candies,Baggry's Crunchy Muesli Almond Raisins & Honey,13000,0,5,13000,200,FALSE,200,0,1,40000,65,High,0.2,13000,2600000
Chocolates & Candies,Knorr Chinese Hot And Sour Veg Soup,5500,3,1,5300,43,FALSE,43,200,1,1849,123.26,High,0.043,5300,227900
Chocolates & Candies,Go Cheese Spread - Garlic,9900,5,6,9400,200,FALSE,200,500,1,40000,47,High,0.2,9400,1880000
Chocolates & Candies,The Whole Truth Peanut Butter With Dates - Creamy No Sugar,21500,9,6,19400,325,FALSE,325,2100,1,105625,59.69,High,0.325,19400,6305000
Chocolates & Candies,Zorabian Chicken Smoked Ham,20500,5,1,19400,250,FALSE,250,1100,1,62500,77.6,High,0.25,19400,4850000
Chocolates & Candies,Kissan Pineapple Jam,16500,9,1,14900,500,FALSE,500,1600,1,250000,29.8,High,0.5,14900,7450000
Chocolates & Candies,Smith & Jones Masala Noodles,8900,0,5,8900,480,FALSE,480,0,0.9,230400,18.54,High,0.48,8900,4272000
Chocolates & Candies,Nestle Nestle Nan Pro Follow-Up Formula,65000,0,6,65000,400,FALSE,400,0,1,160000,162.5,High,0.4,65000,26000000
Chocolates & Candies,Sunfeast Yippee! Power Up Atta Noodles,9600,15,6,8100,280,FALSE,280,1500,1,78400,28.93,High,0.28,8100,2268000
Chocolates & Candies,McCain Super Wedges,12000,7,6,11100,400,FALSE,400,900,1,160000,27.75,High,0.4,11100,4440000
Chocolates & Candies,"Kellogg's Crunchy Granola Honey, Almonds, Strawberries & Pumpkin Seeds",33000,10,1,29400,450,FALSE,450,3600,1,202500,65.33,High,0.45,29400,13230000
Chocolates & Candies,Kellogg's Chocos,13000,10,6,11700,250,FALSE,250,1300,1,62500,46.8,High,0.25,11700,2925000
Chocolates & Candies,Ching's Secret Just Soak - Whole Wheat Veg Hakka Noodle,3200,0,3,3200,150,FALSE,150,0,1,22500,21.33,Medium,0.15,3200,480000
Chocolates & Candies,The Whole Truth Vegan Fig Apricot & Orange Energy Bar No Sugar,6000,20,6,4800,40,FALSE,40,1200,1,1600,120,High,0.04,4800,192000
Chocolates & Candies,Saffola Veggie Twist Masala Oats,19500,12,2,17100,500,FALSE,500,2400,1,250000,34.2,High,0.5,17100,8550000
Chocolates & Candies,ITC Master Chef Classic Aloo Tikki,8000,10,3,7200,320,FALSE,320,800,1,102400,22.5,High,0.32,7200,2304000
Chocolates & Candies,Smith & Jones Pink Pasta Sauce Mix,4000,0,4,4000,46,FALSE,46,0,1,2116,86.96,High,0.046,4000,184000
Chocolates & Candies,Wingreens Farms Chipotle Dip,20000,25,1,15000,180,FALSE,180,5000,1,32400,83.33,High,0.18,15000,2700000
Chocolates & Candies,Kellogg's Real Almond & Honey Corn Flakes,55000,5,3,52000,1000,FALSE,1,3000,1,1000,52,High,1,52000,52000
Chocolates & Candies,Kellogg's Crunchy Granola Chocolate & Almonds,33000,10,3,29400,450,FALSE,450,3600,1,202500,65.33,High,0.45,29400,13230000
Chocolates & Candies,Cornitos Cornitos Taco Shells - 6 Inches,16000,20,4,12800,180,FALSE,180,3200,1,32400,71.11,High,0.18,12800,2304000
Chocolates & Candies,Ching's Secret Singapore Curry Instant Noodles,1500,0,3,1500,60,FALSE,60,0,1,3600,25,Low,0.06,1500,90000
Chocolates & Candies,Mother's Recipe Pickle - Mango,12500,9,6,11300,400,FALSE,500,1200,1,200000,28.25,High,0.4,11300,5650000
Chocolates & Candies,Godrej Yummiez Chilli Chicken Sausages ,16000,10,3,14400,250,FALSE,250,1600,1,62500,57.6,High,0.25,14400,3600000
Chocolates & Candies,Pedigree Dentastix  Dog Treat Oral Care for Adult Medium Breed ,17500,20,6,14000,180,FALSE,180,3500,1,32400,77.78,High,0.18,14000,2520000
Chocolates & Candies,Maggi Hot & Sweet - Tomato Chilli Sauce,17000,10,1,15300,1000,FALSE,1,1700,0.9,1000,15.3,High,1,15300,15300
Chocolates & Candies,Ching's Secret Asian Hot Instant Soup,1500,0,3,1500,15,FALSE,15,0,1,225,100,Low,0.015,1500,22500
Chocolates & Candies,Kelloggs Chocos Protein And Fibre Of 1 Roti,49900,11,6,44400,1200,FALSE,1,5500,1,1200,37,High,1.2,44400,44400
Chocolates & Candies,Mother's Recipe Pickle - Mango,14900,26,4,10900,500,FALSE,500,4000,1,250000,21.8,High,0.5,10900,5450000
Chocolates & Candies,Chings Secret Manchurian Instant Noodle,6000,0,6,6000,240,FALSE,240,0,1,57600,25,High,0.24,6000,1440000
Chocolates & Candies,Kellogg's Original Corn Flakes,31000,6,6,29000,875,FALSE,875,2000,1,765625,33.14,High,0.875,29000,25375000
Chocolates & Candies,Ching's Singapore Curry Instant Noodles,6000,0,4,6000,240,FALSE,240,0,1,57600,25,High,0.24,6000,1440000
Chocolates & Candies,Kellogg's Almonds And Cranberries Granola,33000,6,6,31000,460,FALSE,460,2000,1,211600,67.39,High,0.46,31000,14260000
Chocolates & Candies,Nestle Ceregrow Multigrain Cereal with Milk and Fruits - 3 to 6 years,29200,0,6,29200,300,FALSE,300,0,1,90000,97.33,High,0.3,29200,8760000
Chocolates & Candies,MTR 3 Minute Breakfast - Magic Masala Upma,2500,0,6,2500,60,FALSE,60,0,1,3600,41.67,Medium,0.06,2500,150000
Chocolates & Candies,Smith & Jones Masala Noodles,6800,10,5,6100,360,FALSE,360,700,0.9,129600,16.94,High,0.36,6100,2196000
Chocolates & Candies,"Knorr Classic Tomato Soup With 100% Real Vegetabls, No Added Preservatives",5500,0,6,5500,53,FALSE,53,0,1,2809,103.77,High,0.053,5500,291500
Chocolates & Candies,Godrej Yummiez Chicken Punjabi Tikka ,29500,9,6,26600,360,FALSE,360,2900,1,129600,73.89,High,0.36,26600,9576000
Chocolates & Candies,Kellogg's Corn Flakes,42500,9,1,38300,1000,FALSE,1,4200,1,1000,38.3,High,1,38300,38300
Chocolates & Candies,Kelloggs Chocos,17000,5,4,16000,385,FALSE,385,1000,1,148225,41.56,High,0.385,16000,6160000
Chocolates & Candies,Pedigree Puppy Dry Dog Food Food Chicken & Milk,29000,20,6,23200,1200,FALSE,1200,5800,1,1440000,19.33,High,1.2,23200,27840000
Chocolates & Candies,Ching's Secret Lemon Coriander Instant Soup,1500,0,5,1500,15,FALSE,15,0,1,225,100,Low,0.015,1500,22500
Chocolates & Candies,Nestle Cerelac Baby Cereal With Milk Wheat-Rice Mixed Fruit,26100,0,6,26100,300,FALSE,300,0,1,90000,87,High,0.3,26100,7830000
Chocolates & Candies,Kelloggs Chocos - Moons & Stars,66000,40,4,39600,1200,FALSE,1,26400,1,1200,33,High,1.2,39600,39600
Chocolates & Candies,ITC Master Chef Chicken Galouti Kebab,17000,4,2,16200,210,FALSE,210,800,1,44100,77.14,High,0.21,16200,3402000
Chocolates & Candies,Yogabar 100% Pure Peanut Butter Creamy & Yummy Unsweetened,22900,10,6,20600,400,FALSE,400,2300,1,160000,51.5,High,0.4,20600,8240000
Chocolates & Candies,Kitchens Of India Palak Paneer,13000,30,6,9100,285,FALSE,285,3900,1,81225,31.93,High,0.285,9100,2593500
Chocolates & Candies,Kelloggs Chocos Fills Double Chocolat,9900,11,6,8800,175,FALSE,175,1100,1,30625,50.29,High,0.175,8800,1540000
Chocolates & Candies,Soulfull Ragi Bites Choco Fills,16900,5,4,16000,250,FALSE,250,900,1,62500,64,High,0.25,16000,4000000
Chocolates & Candies,Figaro Sliced Black Olive ,17900,0,6,17900,450,FALSE,450,0,1,202500,39.78,High,0.45,17900,8055000
Chocolates & Candies,Veeba Barbeque Sauce,14900,8,6,13700,330,FALSE,330,1200,1,108900,41.52,High,0.33,13700,4521000
Chocolates & Candies,The Whole Truth Vegan Mocha Almond Fudge Energy Bar No Sugar,6000,20,6,4800,40,FALSE,40,1200,1,1600,120,High,0.04,4800,192000
Chocolates & Candies,"The Whole Truth - Nuts, Fruits & Seeds Muesli",32500,20,6,26000,350,FALSE,350,6500,1,122500,74.29,High,0.35,26000,9100000
Chocolates & Candies,Pantai Green Curry Paste,15000,14,5,12800,114,FALSE,114,2200,1,12996,112.28,High,0.114,12800,1459200
Chocolates & Candies,Kelloggs Special K,21000,8,5,19200,435,FALSE,435,1800,1,189225,44.14,High,0.435,19200,8352000
Chocolates & Candies,Moi Soi Sichuan Chilli Oil- For Stir Fry Marinade Spread & Dip,28000,50,5,14000,175,FALSE,175,14000,1,30625,80,High,0.175,14000,2450000
Chocolates & Candies,Mother's Recipe Madras Appalam,5000,10,6,4500,100,FALSE,100,500,1,10000,45,High,0.1,4500,450000
Chocolates & Candies,Top Ramen Masala Oat Masala,8000,10,6,7200,280,FALSE,280,800,1,78400,25.71,High,0.28,7200,2016000
Chocolates & Candies,Saffola Everyday Peppy Tomato Masala Oats,19500,12,6,17100,500,FALSE,500,2400,1,250000,34.2,High,0.5,17100,8550000
Chocolates & Candies,"Ching's Secret Instant Noodles, Hot Garlic",6000,0,4,6000,240,FALSE,240,0,1,57600,25,High,0.24,6000,1440000
Chocolates & Candies,Kitchens Of India Chicken Chettinad,20000,30,1,14000,285,FALSE,285,6000,1,81225,49.12,High,0.285,14000,3990000
Chocolates & Candies,Nestle Cerelac Wheat - Stage 1,19000,0,6,19000,300,FALSE,300,0,1,90000,63.33,High,0.3,19000,5700000
Chocolates & Candies,Sumeru Aloo Paratha,11900,5,6,11300,400,FALSE,400,600,1,160000,28.25,High,0.4,11300,4520000
Chocolates & Candies,ITC Master Chef Veggie Pizza Pocket,17000,4,4,16200,340,FALSE,340,800,1,115600,47.65,High,0.34,16200,5508000
Chocolates & Candies,Wingreens Farms Tangy Cheese Pita Chips & Mexican Salsa Dip,6000,15,1,5100,70,FALSE,70,900,1,4900,72.86,High,0.07,5100,357000
Chocolates & Candies,Ching's Secret Manchow Soup,5500,0,3,5500,55,FALSE,55,0,1,3025,100,High,0.055,5500,302500
Chocolates & Candies,Veeba Carrot & Cucumber Sandwich Spread,8500,10,6,7600,250,FALSE,250,900,1,62500,30.4,High,0.25,7600,1900000
Chocolates & Candies,Kellogg's Real Almond & Honey Corn Flakes,37000,12,3,32400,650,FALSE,650,4600,1,422500,49.85,High,0.65,32400,21060000
Chocolates & Candies,Kitchens Of India Mughlai Paneer,16000,30,4,11200,285,FALSE,285,4800,1,81225,39.3,High,0.285,11200,3192000
Chocolates & Candies,Ching's Secret Just Soak - Veg Hakka Noodles,3000,0,5,3000,150,FALSE,150,0,1,22500,20,Medium,0.15,3000,450000
Chocolates & Candies,Ching's Secret Chowmein Hakka Noodles Masala,6000,10,2,5400,100,FALSE,100,600,1,10000,54,High,0.1,5400,540000
Chocolates & Candies,The Whole Truth Dark Chocolate Peanut Butter - Crunchy,23500,20,5,18800,325,FALSE,325,4700,1,105625,57.85,High,0.325,18800,6110000
Chocolates & Candies,Mother's Recipe Bhel Puri Chutney,5500,9,4,5000,200,FALSE,200,500,1,40000,25,High,0.2,5000,1000000
Chocolates & Candies,Kelloggs Chocos Moon & Stars,33000,10,6,29400,680,FALSE,680,3600,1,462400,43.24,High,0.68,29400,19992000
Chocolates & Candies,Mother's Recipe Lime Pickle ,12000,5,1,11400,400,FALSE,400,600,1,160000,28.5,High,0.4,11400,4560000
Chocolates & Candies,Kitchens of India Dal Makhani,11000,30,2,7700,285,FALSE,285,3300,1,81225,27.02,High,0.285,7700,2194500
Chocolates & Candies,Pantai Light Soy Sauce,27500,14,5,23400,200,FALSE,200,4100,1,40000,117,High,0.2,23400,4680000
Chocolates & Candies,Ching's Secret Sweet Corn Soup,5500,0,6,5500,55,FALSE,55,0,1,3025,100,High,0.055,5500,302500
Chocolates & Candies,"Top Ramen Noodles, Atta",8000,0,1,8000,280,FALSE,280,0,1,78400,28.57,High,0.28,8000,2240000
Chocolates & Candies,Cantina Tortilla Dip Sauce Sour Creamy Tex Mex,22500,15,5,19100,190,FALSE,190,3400,1,36100,100.53,High,0.19,19100,3629000
Chocolates & Candies,Dabur Hommade - Rajasthan Ki Garlic Chutne,6500,6,6,6100,200,FALSE,200,400,1,40000,30.5,High,0.2,6100,1220000
Chocolates & Candies,MTR Seviyan Vermicelli ,4200,0,2,4200,400,FALSE,400,0,0.9,160000,10.5,High,0.4,4200,1680000
Chocolates & Candies,Pantai Oyster Sauce,27500,14,4,23400,200,FALSE,200,4100,1,40000,117,High,0.2,23400,4680000
Chocolates & Candies,Go Cheese Spread - Four Pepper (Soft & Creamy),9900,5,6,9400,200,FALSE,200,500,1,40000,47,High,0.2,9400,1880000
Chocolates & Candies,MTR Ready To Eat Paneer Butter Masala,13500,9,2,12200,300,FALSE,300,1300,1,90000,40.67,High,0.3,12200,3660000
Chocolates & Candies,Nestle Lactogen Stage 2 Follow-up Formula Powder,34000,0,2,34000,400,FALSE,400,0,1,160000,85,High,0.4,34000,13600000
Chocolates & Candies,Kellogg's Crunchy Bites Chocos,19000,10,6,17100,375,FALSE,375,1900,1,140625,45.6,High,0.375,17100,6412500
Chocolates & Candies,Veeba Hot Sweet Tomato Chilli Sauce,10400,20,3,8300,500,FALSE,500,2100,1,250000,16.6,High,0.5,8300,4150000
Chocolates & Candies,Borges Durum Wheat Pasta Superior Quality,25000,40,6,14900,500,FALSE,500,10100,1,250000,29.8,High,0.5,14900,7450000
Chocolates & Candies,Funfoods Peanut Butter Crunchy,16900,7,1,15600,400,FALSE,400,1300,1,160000,39,High,0.4,15600,6240000
Chocolates & Candies,Pantai Red Curry Paste,6000,0,4,6000,50,FALSE,50,0,1,2500,120,High,0.05,6000,300000
Chocolates & Candies,ITC Master Chef Chicken Seekh Kabab,32500,0,6,32500,500,FALSE,500,0,1,250000,65,High,0.5,32500,16250000
Chocolates & Candies,Del Monte Pizza & Pasta Sauce Spout Pack,9900,0,3,9900,400,FALSE,400,0,1,160000,24.75,High,0.4,9900,3960000
Chocolates & Candies,Pantai Sriracha Red Chilli Sauce,22500,15,6,19100,200,FALSE,200,3400,1,40000,95.5,High,0.2,19100,3820000
Chocolates & Candies,Hershey's Cocoa Spread,29500,0,3,29500,350,FALSE,350,0,1,122500,84.29,High,0.35,29500,10325000
Chocolates & Candies,Maggi Ghee Tadka Upma Express Pouch,2500,0,6,2500,65,FALSE,65,0,1,4225,38.46,Medium,0.065,2500,162500
Chocolates & Candies,Ching's Secret Manchurian Noodles,9100,0,5,9100,360,FALSE,360,0,1,129600,25.28,High,0.36,9100,3276000
Chocolates & Candies,Kellogg's All Bran Wheat Flakes,22000,6,5,20500,425,FALSE,425,1500,1,180625,48.24,High,0.425,20500,8712500
Chocolates & Candies,Yummiez Chicken Breakfast Sausages,15000,0,3,15000,250,FALSE,250,0,1,62500,60,High,0.25,15000,3750000
Chocolates & Candies,Pantai Red Curry Paste,15000,14,3,12800,114,FALSE,114,2200,1,12996,112.28,High,0.114,12800,1459200
Chocolates & Candies,Bagrrys Muesli Crunchy Fruit & Nut With Cranberries,33000,10,6,29700,400,FALSE,400,3300,1,160000,74.25,High,0.4,29700,11880000
Chocolates & Candies,Quaker Oats Pouch,27600,10,6,24800,1500,FALSE,1,2800,0.9,1500,16.53,High,1.5,24800,24800
Chocolates & Candies,Prasuma Momos -  Cheesy Spicy Veg,29500,0,6,29500,24,FALSE,24,0,1,576,1229.17,High,0.024,29500,708000
Chocolates & Candies,Veeba Sriracha Chilli Garlic Sauce,14900,8,5,13700,320,FALSE,320,1200,1,102400,42.81,High,0.32,13700,4384000
Chocolates & Candies,Ching's Secret Just Soak - Veg Hakka Noodles,11500,0,6,11500,600,FALSE,600,0,0.9,360000,19.17,High,0.6,11500,6900000
Chocolates & Candies,Moi Soi Kung Pao Sauce - For Stir Fry Marinade Spread & Dip,28000,50,5,14000,175,FALSE,175,14000,1,30625,80,High,0.175,14000,2450000
Chocolates & Candies,Figaro Plain Green Olive ,17900,0,6,17900,450,FALSE,450,0,1,202500,39.78,High,0.45,17900,8055000
Chocolates & Candies,Mother's Recipe Gujrati Gorkeri Pickle,14000,10,3,12600,500,FALSE,500,1400,1,250000,25.2,High,0.5,12600,6300000
Chocolates & Candies,Kellogg's Muesli 20% Nuts Delight,32000,0,6,32000,500,FALSE,500,0,1,250000,64,High,0.5,32000,16000000
Chocolates & Candies,Borges Farfalle Durum Wheat Pasta ,25000,0,5,25000,500,FALSE,500,0,1,250000,50,High,0.5,25000,12500000
Chocolates & Candies,Kellogg's Chocos,29900,10,4,26900,700,FALSE,700,3000,1,490000,38.43,High,0.7,26900,18830000
Chocolates & Candies,Nestle Nan Pro 4 Follow Up Formula Powder For Older Infants ,62000,0,1,62000,400,FALSE,400,0,1,160000,155,High,0.4,62000,24800000
Chocolates & Candies,Veeba Truly Tomato Ketchup,9900,20,6,7900,500,FALSE,500,2000,0.9,250000,15.8,High,0.5,7900,3950000
Chocolates & Candies,Ching's Secret Green Chilli Sauce,8500,4,1,8100,680,FALSE,680,400,0.9,462400,11.91,High,0.68,8100,5508000
Chocolates & Candies,MTR Roasted Vermicelli ,5500,0,1,5500,400,FALSE,400,0,0.9,160000,13.75,High,0.4,5500,2200000
Chocolates & Candies,Mother's Recipe Punjabi Teekha Mang Pickle,12000,10,4,10800,400,FALSE,400,1200,1,160000,27,High,0.4,10800,4320000
Chocolates & Candies,Ching's Secret Hot Garlic Instant Noodles,11400,0,6,11400,480,FALSE,480,0,1,230400,23.75,High,0.48,11400,5472000
Chocolates & Candies,Kellogg's Real Honey Corn Flakes,29000,7,5,26700,630,FALSE,630,2300,1,396900,42.38,High,0.63,26700,16821000
Chocolates & Candies,ITC Master Chef Lebanese Falafel Kebab,13000,4,4,12400,230,FALSE,230,600,1,52900,53.91,High,0.23,12400,2852000
Chocolates & Candies,Kelloggs Chocos Fills Double Chocolaty,18500,10,5,16500,250,FALSE,250,2000,1,62500,66,High,0.25,16500,4125000
Chocolates & Candies,Organic India Apple Cider Vinegar,59500,9,2,53600,500,FALSE,500,5900,1,250000,107.2,High,0.5,53600,26800000
Chocolates & Candies,Masala Oats Masala & Coriander ,19500,9,5,17600,500,FALSE,500,1900,1,250000,35.2,High,0.5,17600,8800000
Chocolates & Candies,Ching's Secret  Noodles - Pad Thai Lemongras,20000,0,5,20000,130,FALSE,130,0,1,16900,153.85,High,0.13,20000,2600000
Chocolates & Candies,Bagrrys Fruit and Nut Muesli with Cranberries,49900,0,5,49900,750,FALSE,750,0,1,562500,66.53,High,0.75,49900,37425000
Chocolates & Candies,Kitchens Of India Yellow Dal Tadka,11000,30,6,7700,285,FALSE,285,3300,1,81225,27.02,High,0.285,7700,2194500
Chocolates & Candies,Soulfull Vanilla Fills - Ragi Bites,16900,5,6,16000,250,FALSE,250,900,1,62500,64,High,0.25,16000,4000000
Chocolates & Candies,Pantai Teriyaki Sauce with Garlic,32500,15,6,27600,200,FALSE,200,4900,1,40000,138,High,0.2,27600,5520000
Chocolates & Candies,Whiskas Adult Pocket Tuna Cat Food,41000,0,1,41000,1200,FALSE,1,0,1,1200,34.17,High,1.2,41000,41000
Chocolates & Candies,Kitchens Of India Chicken Darbari ,20000,30,4,14000,285,FALSE,285,6000,1,81225,49.12,High,0.285,14000,3990000
Chocolates & Candies,Soulfull Millet Muesli Fruit & Nut Almonds & Real Fruits,29900,10,6,26900,400,FALSE,400,3000,1,160000,67.25,High,0.4,26900,10760000
Chocolates & Candies,Smith & Jones Red Pasta Sauce Mix,4000,0,6,4000,46,FALSE,46,0,1,2116,86.96,High,0.046,4000,184000
Chocolates & Candies,Kellogg's Muesli Nuts Delight,42500,9,3,38300,750,FALSE,750,4200,1,562500,51.07,High,0.75,38300,28725000
Chocolates & Candies,Kitchens of India Dal Bukhara Gravy Mix,11000,30,6,7700,285,FALSE,285,3300,1,81225,27.02,High,0.285,7700,2194500
Chocolates & Candies,The Whole Truth Peanut Butter - Sweetened & Crunchy,21500,20,6,17200,325,FALSE,325,4300,1,105625,52.92,High,0.325,17200,5590000
Chocolates & Candies,Remia Mayonnaise,23000,0,6,23000,241,FALSE,241,0,1,58081,95.44,High,0.241,23000,5543000
Chocolates & Candies,Ching's Secret Green Chilli Sauce,10500,0,6,10500,425,FALSE,425,0,1,180625,24.71,High,0.425,10500,4462500
Chocolates & Candies,Bagrrys Fruit N Fibre Muesli - Strawberry,59500,0,1,59500,1000,FALSE,1,0,1,1000,59.5,High,1,59500,59500
Chocolates & Candies,Ching's Secret Tomato Oats Instant Soup,1500,0,3,1500,20,FALSE,20,0,1,400,75,Low,0.02,1500,30000
Chocolates & Candies,Kellogg's Special K Original Corn Flakes,14000,5,1,13300,290,FALSE,290,700,1,84100,45.86,High,0.29,13300,3857000
Chocolates & Candies,Moi Soi  Black Bean Sauce - Dip Spread Stir Fry & Marinade,28000,50,5,14000,175,FALSE,175,14000,1,30625,80,High,0.175,14000,2450000
Chocolates & Candies,Tong Garden Wasabi Green Peas,17500,4,6,16700,150,FALSE,150,800,1,22500,111.33,High,0.15,16700,2505000
Chocolates & Candies,Ching's Secret Red Chilli Sauce,10500,0,4,10500,440,FALSE,440,0,1,193600,23.86,High,0.44,10500,4620000
Chocolates & Candies,Ching's Instant Hot and Sour Soup,5500,0,5,5500,55,FALSE,55,0,1,3025,100,High,0.055,5500,302500
Chocolates & Candies,Ching's Secret Noodles - Pad Thai Original,20000,0,6,20000,130,FALSE,130,0,1,16900,153.85,High,0.13,20000,2600000
Chocolates & Candies,Aashirvaad Instant Meals - Khatta Meetha Pohaa With Millets,5500,30,5,3800,80,FALSE,80,1700,1,6400,47.5,High,0.08,3800,304000
Chocolates & Candies,Del Monte Black Sliced Olives,25000,0,1,25000,450,FALSE,450,0,1,202500,55.56,High,0.45,25000,11250000
Chocolates & Candies,Kitchens Of India Murgh Methi,22000,30,5,15400,285,FALSE,285,6600,1,81225,54.04,High,0.285,15400,4389000
Chocolates & Candies,Nestle Cerelac 5 Grains & Fruits Cereal,28800,0,6,28800,300,FALSE,300,0,1,90000,96,High,0.3,28800,8640000
Chocolates & Candies,The Whole Truth - 5 Grain Muesli No Added Sugar,32500,20,6,26000,350,FALSE,350,6500,1,122500,74.29,High,0.35,26000,9100000
Chocolates & Candies,Ching's Secret  Pad Thai Noodles Green Curry,20000,0,6,20000,130,FALSE,130,0,1,16900,153.85,High,0.13,20000,2600000
Chocolates & Candies,Aashirvaad Suji Halwa With Jaggery,7500,0,6,7500,70,FALSE,70,0,1,4900,107.14,High,0.07,7500,525000
Chocolates & Candies,Mother's Recipe Mango Pickle ,12000,0,1,12000,400,FALSE,400,0,1,160000,30,High,0.4,12000,4800000
Chocolates & Candies,Ching's Secret Pad Thai Noodles - Extra Hot Thai Chilli,20000,0,6,20000,130,FALSE,130,0,1,16900,153.85,High,0.13,20000,2600000
Chocolates & Candies,Kellogg's Special K Original Corn Flakes,39900,11,6,35500,900,FALSE,900,4400,1,810000,39.44,High,0.9,35500,31950000
Chocolates & Candies,Knorr Sweet Corn Chicken Soup,5500,0,2,5500,42,FALSE,42,0,1,1764,130.95,High,0.042,5500,231000
Chocolates & Candies,Ching's Secret Tomato Soup,5500,0,6,5500,55,FALSE,55,0,1,3025,100,High,0.055,5500,302500
Chocolates & Candies,Funfoods Peanut Butter Creamy,16900,0,1,16900,400,FALSE,400,0,1,160000,42.25,High,0.4,16900,6760000
Chocolates & Candies,Japanese Choice Udon Noodles,29500,9,6,26600,250,FALSE,250,2900,1,62500,106.4,High,0.25,26600,6650000
Chocolates & Candies,Kelloggs Muesli - With 22% Fruit Magic,32000,10,5,28800,500,FALSE,500,3200,1,250000,57.6,High,0.5,28800,14400000
Chocolates & Candies,Dabur Hommade - Kalonji Tamatar Ki Chutney,6500,6,6,6100,200,FALSE,200,400,1,40000,30.5,High,0.2,6100,1220000
Chocolates & Candies,Kitchens Of India Dal Makhani,11000,30,1,7700,285,FALSE,285,3300,1,81225,27.02,High,0.285,7700,2194500
Chocolates & Candies,Aashirvaad Suji Halwa With Jaggery,5500,30,6,3800,80,FALSE,80,1700,1,6400,47.5,High,0.08,3800,304000
Chocolates & Candies,Del Monte Green Chili Sauce,5500,0,3,5500,190,FALSE,190,0,1,36100,28.95,High,0.19,5500,1045000
Chocolates & Candies,Pedigree Dog Food Adult Chicken & Veg,66000,10,1,59400,3000,FALSE,3,6600,1,9000,19.8,High,3,59400,178200
Chocolates & Candies,Kellogg's Original Corn Flakes,18500,5,6,17500,475,FALSE,475,1000,1,225625,36.84,High,0.475,17500,8312500
Chocolates & Candies,Pedigree Puppy Dry Dog Food Food Chicken & Milk,69000,6,2,64800,3000,FALSE,3,4200,1,9000,21.6,High,3,64800,194400
Chocolates & Candies,Kitchens Of India Rajma Masala,11000,30,5,7700,285,FALSE,285,3300,1,81225,27.02,High,0.285,7700,2194500
Chocolates & Candies,Kitchen Of India Ready-To-Eat Pindi Channa,11000,30,2,7700,285,FALSE,285,3300,1,81225,27.02,High,0.285,7700,2194500
Chocolates & Candies,Figaro Pitted Black Olive ,17900,0,6,17900,450,FALSE,450,0,1,202500,39.78,High,0.45,17900,8055000
Chocolates & Candies,Cantina Tabasco Red Sauce,14000,15,6,11900,60,FALSE,60,2100,1,3600,198.33,High,0.06,11900,714000
Chocolates & Candies,Mother's Recipe Pickle - Mixed,14900,26,6,10900,500,FALSE,500,4000,1,250000,21.8,High,0.5,10900,5450000
Chocolates & Candies,Nestle Cerelac Baby Cereal with Milk 5 Grains & Vegetables from 18 to 24 Month,27900,0,5,27900,300,FALSE,300,0,1,90000,93,High,0.3,27900,8370000
Chocolates & Candies,Mother's Recipe Tamarind Paste,5000,2,2,4900,200,FALSE,200,100,1,40000,24.5,High,0.2,4900,980000
Chocolates & Candies,Pedigree Meat Jerky Adult Dog Treat Barbecued Chicken,14000,20,6,11200,80,FALSE,80,2800,1,6400,140,High,0.08,11200,896000
Chocolates & Candies,Veeba Peri Peri Sauce,16100,0,6,16100,300,FALSE,300,0,1,90000,53.67,High,0.3,16100,4830000
Chocolates & Candies,Pantai Sriracha Yellow Chilli Sauce,22500,15,6,19100,200,FALSE,200,3400,1,40000,95.5,High,0.2,19100,3820000
Chocolates & Candies,Praakritik Organic Jumbo Rolled Oats,19000,11,6,16900,500,FALSE,500,2100,1,250000,33.8,High,0.5,16900,8450000
Chocolates & Candies,Ching's Secret Just Soak - Whole Wheat Veg Hakka Noodles,12300,0,6,12300,600,FALSE,600,0,1,360000,20.5,High,0.6,12300,7380000
Chocolates & Candies,Pantai Spring Roll Sauce,27500,10,6,24500,200,FALSE,200,3000,1,40000,122.5,High,0.2,24500,4900000
Chocolates & Candies,MTR Vermicelli Payasam,7500,0,6,7500,180,FALSE,180,0,1,32400,41.67,High,0.18,7500,1350000
Chocolates & Candies,Bagrrys Corn Flakes,35000,0,6,35000,880,FALSE,800,0,1,704000,39.77,High,0.88,35000,28000000
Chocolates & Candies,MTR Ready To Eat Palak Paneer ,13500,11,6,12000,300,FALSE,300,1500,1,90000,40,High,0.3,12000,3600000
Chocolates & Candies,Del Monte Red Chili Sauce,5500,0,5,5500,190,FALSE,190,0,1,36100,28.95,High,0.19,5500,1045000
Chocolates & Candies,Kitchens of India Mutter Paneer Mix,12000,30,4,8400,285,FALSE,285,3600,1,81225,29.47,High,0.285,8400,2394000
Chocolates & Candies,Pantai Green Curry Paste,6000,6,6,5600,50,FALSE,50,400,1,2500,112,High,0.05,5600,280000
Chocolates & Candies,The Laughing Cow Cheese Spread Plain,11000,0,6,11000,180,FALSE,180,0,1,32400,61.11,High,0.18,11000,1980000
Chocolates & Candies,MTR Dal Fry,11000,0,5,11000,300,FALSE,300,0,1,90000,36.67,High,0.3,11000,3300000
Chocolates & Candies,Pantai Fish Sauce,27500,14,6,23400,200,FALSE,200,4100,1,40000,117,High,0.2,23400,4680000
Chocolates & Candies,Cantina Beans Mexican Beans,25000,14,6,21300,410,FALSE,410,3700,1,168100,51.95,High,0.41,21300,8733000
Chocolates & Candies,Ching's Secret Manchurian Instant Noodle,11400,0,6,11400,480,FALSE,480,0,1,230400,23.75,High,0.48,11400,5472000
Chocolates & Candies,Remia Salad Italian Dressing ,23000,0,6,23000,250,FALSE,250,0,1,62500,92,High,0.25,23000,5750000
Chocolates & Candies,Yummiez Veg Cheese Fingers Pouch,23000,0,4,23000,400,FALSE,400,0,1,160000,57.5,High,0.4,23000,9200000
Chocolates & Candies,MTR Dal Makhani,11000,0,4,11000,300,FALSE,300,0,1,90000,36.67,High,0.3,11000,3300000
Chocolates & Candies,MTR Ready to Eat Pav Bhaji,11000,0,6,11000,300,FALSE,300,0,1,90000,36.67,High,0.3,11000,3300000
Chocolates & Candies,Weikfield Tomato Salsa Instant Pasta,2500,0,1,2500,77,FALSE,77,0,1,5929,32.47,Medium,0.077,2500,192500
Chocolates & Candies,Nestlé CERELAC Baby Cereal with Milk,27200,0,1,27200,300,FALSE,300,0,1,90000,90.67,High,0.3,27200,8160000
Chocolates & Candies,Remia Salad Caesar Dressing,25000,0,6,25000,250,FALSE,250,0,1,62500,100,High,0.25,25000,6250000
Chocolates & Candies,Bagrrys Fruit N Fibre Muesli Mixed Fruit,33000,0,6,33000,500,FALSE,500,0,1,250000,66,High,0.5,33000,16500000
Chocolates & Candies,MTR Paneer Butter Masala & Veg Pulao,17500,9,4,15800,375,FALSE,375,1700,1,140625,42.13,High,0.375,15800,5925000
Chocolates & Candies,Sundrop Cocoa Nut Hazelnut Chocolatey Spread,12000,0,6,12000,160,FALSE,160,0,1,25600,75,High,0.16,12000,1920000
Chocolates & Candies,Moi Soi Manchurian Sauce - For Stir Fry Marinade Spread & Dip,28000,50,6,14000,175,FALSE,175,14000,1,30625,80,High,0.175,14000,2450000
Chocolates & Candies,Pedigree Dog Food Adult Meat & Rice,66000,7,2,60800,3000,FALSE,3,5200,1,9000,20.27,High,3,60800,182400
Chocolates & Candies,Pantai Sriracha Green Chilli Sauce,22500,15,6,19100,200,FALSE,200,3400,1,40000,95.5,High,0.2,19100,3820000
Chocolates & Candies,Pantai Chilli Garlic Sauce,27500,14,6,23400,200,FALSE,200,4100,1,40000,117,High,0.2,23400,4680000
Chocolates & Candies,Pantai Dark Soy Sauce,27500,14,6,23400,200,FALSE,200,4100,1,40000,117,High,0.2,23400,4680000
Chocolates & Candies,Yoga Bar Peanut Butter Dark Chocolate Jar,24900,0,4,24900,400,FALSE,400,0,1,160000,62.25,High,0.4,24900,9960000
Chocolates & Candies,Cantina Tabasco Green Sauce,14000,15,6,11900,60,FALSE,60,2100,1,3600,198.33,High,0.06,11900,714000
Chocolates & Candies,Pantai Pad Thai Sauce (Non-Veg),32500,9,5,29300,200,FALSE,200,3200,1,40000,146.5,High,0.2,29300,5860000
Chocolates & Candies,Pantai Sweet Chilli Sauce,27500,14,6,23400,200,FALSE,200,4100,1,40000,117,High,0.2,23400,4680000
Chocolates & Candies,Ching's Secret Schezwan Instant Noodle,11400,0,6,11400,480,FALSE,480,0,1,230400,23.75,High,0.48,11400,5472000
Chocolates & Candies,Yummiez Chicken Garlic Fingers Pouch,25000,0,5,25000,400,FALSE,400,0,1,160000,62.5,High,0.4,25000,10000000
Chocolates & Candies,Pediasure Premium Chocolate Powdered Health Drink,61000,0,2,61000,400,FALSE,400,0,1,160000,152.5,High,0.4,61000,24400000
Chocolates & Candies,Chings Secret Hot Garlic Instant Noodles,9100,0,6,9100,60,FALSE,60,0,1,3600,151.67,High,0.06,9100,546000
Chocolates & Candies,Godrej Yummiez Cheese Corn Nuggets ,23000,0,4,23000,400,FALSE,400,0,1,160000,57.5,High,0.4,23000,9200000
Chocolates & Candies,Pantai Hot Chilli Sauce,27500,14,6,23400,200,FALSE,200,4100,1,40000,117,High,0.2,23400,4680000
Chocolates & Candies,Knorr International Mexican Tomato Corn Soup ,6500,6,3,6100,52,FALSE,52,400,1,2704,117.31,High,0.052,6100,317200
Chocolates & Candies,Bagrry's Fruit Fibre Muesli Mixed Fruit ,59500,0,5,59500,1000,FALSE,1,0,1,1000,59.5,High,1,59500,59500
Chocolates & Candies,MTR Roasted Vermicelli ,10500,0,4,10500,850,FALSE,850,0,0.9,722500,12.35,High,0.85,10500,8925000
Chocolates & Candies,Maggi 2-Minute Instant Noodles - Masala,4400,0,0,4400,280,TRUE,280,0,0.9,78400,15.71,High,0.28,4400,1232000
Chocolates & Candies,"Kurkure Green Chutney, Rajasthani Style",2000,0,0,2000,90,TRUE,90,0,1,8100,22.22,Medium,0.09,2000,180000
Chocolates & Candies,Kellogg's Chocos Combo Pack,6000,6,0,5600,156,TRUE,156,400,1,24336,35.9,High,0.156,5600,873600
Chocolates & Candies,Kissan Mixed Fruit Jam ,15500,0,0,15500,500,TRUE,500,0,1,250000,31,High,0.5,15500,7750000
Chocolates & Candies,Lijjat Urad Papad,6000,5,0,5700,200,TRUE,200,300,1,40000,28.5,High,0.2,5700,1140000
Chocolates & Candies,Amul Cheese Spread Yummy Plain,8500,0,0,8500,200,TRUE,200,0,1,40000,42.5,High,0.2,8500,1700000
Chocolates & Candies,Mother's Recipe Ginger And Garlic Paste,5000,24,0,3800,200,TRUE,200,1200,1,40000,19,High,0.2,3800,760000
Chocolates & Candies,Maggi Magic Cubes Chicken,4000,2,0,3900,40,TRUE,40,100,1,1600,97.5,High,0.04,3900,156000
Chocolates & Candies,Pedigree Puppy Chicken Chunks in Gravy ,3500,2,0,3400,70,TRUE,70,100,1,4900,48.57,Medium,0.07,3400,238000
Chocolates & Candies,The Whole Truth Peanut Butter - Unsweetened & Crunchy,18500,20,0,14800,325,TRUE,325,3700,1,105625,45.54,High,0.325,14800,4810000
Chocolates & Candies,Ching's Chow Mein Hakka Noodles Masala,1000,0,0,1000,20,TRUE,20,0,1,400,50,Low,0.02,1000,20000
Chocolates & Candies,Safal Frozen Mixed Vegetables,6000,5,0,5700,500,TRUE,500,300,0.9,250000,11.4,High,0.5,5700,2850000
Chocolates & Candies,Safal Frozen Corn,4100,4,0,3900,200,TRUE,200,200,1,40000,19.5,High,0.2,3900,780000
Chocolates & Candies,Amul Cheese Spread Spicy Garlic,8500,3,0,8200,200,TRUE,200,300,1,40000,41,High,0.2,8200,1640000
Chocolates & Candies,Ching's Secret Veg Hakka Noodles,10700,0,0,10700,600,TRUE,600,0,0.9,360000,17.83,High,0.6,10700,6420000
Chocolates & Candies,Saffola Oats 100 % Natural,1500,0,0,1500,38,TRUE,38,0,1,1444,39.47,Low,0.038,1500,57000
Chocolates & Candies,Lijjat Moong Papad,6000,5,0,5700,200,TRUE,200,300,1,40000,28.5,High,0.2,5700,1140000
Chocolates & Candies,Mothers Recipe Papad - Sabudana With Rock Salt,3100,9,0,2800,70,TRUE,70,300,1,4900,40,Medium,0.07,2800,196000
Chocolates & Candies,Maggi Chilly Chow Cuppa Noodles,5000,0,0,5000,70,TRUE,70,0,1,4900,71.43,High,0.07,5000,350000
Chocolates & Candies,Veeba Favourites Eggless Burger Mayonnaise,6900,8,0,6300,250,TRUE,250,600,1,62500,25.2,High,0.25,6300,1575000
Chocolates & Candies,Sunfeast Yippee! Magic Masala Noodles,4800,6,0,4500,240,TRUE,240,300,1,57600,18.75,High,0.24,4500,1080000
Chocolates & Candies,Top Ramen Masala,9100,9,0,8200,560,TRUE,560,900,0.9,313600,14.64,High,0.56,8200,4592000
Chocolates & Candies,Kelloggs Corn Flakes With Real Strawberry Pure,26500,10,0,23600,575,TRUE,575,2900,1,330625,41.04,High,0.575,23600,13570000
Chocolates & Candies,Mother's Recipe Potato Papad,3100,9,0,2800,70,TRUE,75,300,1,5250,40,Medium,0.07,2800,210000
Chocolates & Candies,Mothers Recipe Rice Papad Ajwain,2400,0,0,2400,75,TRUE,75,0,1,5625,32,Medium,0.075,2400,180000
Chocolates & Candies,Chef's Basket Durum Wheat Penne Pasta,16000,50,0,8000,500,TRUE,500,8000,1,250000,16,High,0.5,8000,4000000
Chocolates & Candies,Dabur Hommade - Imli Sauce Saunth,2000,10,0,1800,100,TRUE,100,200,1,10000,18,Medium,0.1,1800,180000
Chocolates & Candies,Zorabian Chicken Kheema Parathas,19000,0,0,19000,300,TRUE,300,0,1,90000,63.33,High,0.3,19000,5700000
Chocolates & Candies,Sunfeast Pasta Treat Pack of Tomato Cheese,2800,17,0,2300,65,TRUE,65,500,1,4225,35.38,Medium,0.065,2300,149500
Chocolates & Candies,Safal Frozen - Sweet Corn,16000,5,0,15200,1000,TRUE,1,800,0.9,1000,15.2,High,1,15200,15200
Chocolates & Candies,MTR Vegetable Upma,2500,0,0,2500,60,TRUE,60,0,1,3600,41.67,Medium,0.06,2500,150000
Chocolates & Candies,Del Monte Original Blend Tomato Ketchup Pouch,12000,7,0,11100,950,TRUE,950,900,0.9,902500,11.68,High,0.95,11100,10545000
Chocolates & Candies,Del Monte Natural Vinegar ,5500,3,0,5300,180,TRUE,180,200,1,32400,29.44,High,0.18,5300,954000
Chocolates & Candies,Del Monte Eggless Mayo,13500,6,0,12600,500,TRUE,500,900,1,250000,25.2,High,0.5,12600,6300000
Chocolates & Candies,ITC Master Chef Cheesy Corn Triangles,16000,5,0,15200,320,TRUE,320,800,1,102400,47.5,High,0.32,15200,4864000
Chocolates & Candies,Mother's Recipe Mixed Pickle ,11500,4,0,11000,400,TRUE,400,500,1,160000,27.5,High,0.4,11000,4400000
Chocolates & Candies,Godrej Yummiez Chicken Breakfast Salami,15000,4,0,14300,250,TRUE,250,700,1,62500,57.2,High,0.25,14300,3575000
Chocolates & Candies,Hershey's Cocoa + Almond Spread,29500,9,0,26600,350,TRUE,350,2900,1,122500,76,High,0.35,26600,9310000
Chocolates & Candies,Maggi Special Masala Spicy Yummy Noodles,7200,0,0,7200,280,TRUE,280,0,1,78400,25.71,High,0.28,7200,2016000
Chocolates & Candies,Del Monte Schezwan Sauce,5500,0,0,5500,190,TRUE,190,0,1,36100,28.95,High,0.19,5500,1045000
Chocolates & Candies,Yummiez Green Peas,13500,0,0,13500,500,TRUE,500,0,1,250000,27,High,0.5,13500,6750000
Chocolates & Candies,Yummiez Green Peas,25000,0,0,25000,1000,TRUE,1,0,1,1000,25,High,1,25000,25000
Chocolates & Candies,Yummiez American Sweet Corn,8500,0,0,8500,400,TRUE,400,0,1,160000,21.25,High,0.4,8500,3400000
Chocolates & Candies,Dr Oetker Cucumber & Carrot Sandwich Spread Veg,7900,0,0,7900,250,TRUE,250,0,1,62500,31.6,High,0.25,7900,1975000
Chocolates & Candies,Del Monte Pitted Green Olives,25000,0,0,25000,450,TRUE,450,0,1,202500,55.56,High,0.45,25000,11250000
"Meats, Fish & Eggs",Arden Eggs White,9700,0,4,9700,696,FALSE,12,0,0.9,8352,13.94,High,0.696,9700,116400
"Meats, Fish & Eggs",Arden Eggs White,6500,15,4,5500,348,FALSE,6,1000,0.9,2088,15.8,High,0.348,5500,33000
"Meats, Fish & Eggs",Arden Eggs Brown,8500,7,4,7900,348,FALSE,6,600,1,2088,22.7,High,0.348,7900,47400
"Meats, Fish & Eggs",Godrej Real Good Chicken Whole Pre-Cut,30000,10,4,27000,1000,FALSE,1,3000,1,1000,27,High,1,27000,27000
"Meats, Fish & Eggs",Zorabian Chicken Breast Boneless,14500,8,3,13300,250,FALSE,250,1200,1,62500,53.2,High,0.25,13300,3325000
"Meats, Fish & Eggs",Godrej Real Good Chicken Curry Cut,17500,9,3,15800,500,FALSE,500,1700,1,250000,31.6,High,0.5,15800,7900000
"Meats, Fish & Eggs",TGFC Chicken Curry Cut Fresh,24900,25,1,18600,500,FALSE,500,6300,1,250000,37.2,High,0.5,18600,9300000
"Meats, Fish & Eggs",Arden Desi Eggs,11000,13,4,9500,348,FALSE,6,1500,1,2088,27.3,High,0.348,9500,57000
"Meats, Fish & Eggs",Godrej Real Good Chicken Breast Boneless,27500,9,6,24800,450,FALSE,450,2700,1,202500,55.11,High,0.45,24800,11160000
"Meats, Fish & Eggs",Fresh Chicken Boneless Cubes (Halal),21500,5,1,20400,500,FALSE,500,1100,1,250000,40.8,High,0.5,20400,10200000
"Meats, Fish & Eggs",Godrej Real Good Chicken Kheema,25500,9,3,23000,450,FALSE,450,2500,1,202500,51.11,High,0.45,23000,10350000
"Meats, Fish & Eggs",Suguna Sharp Egg ,7200,13,3,6200,348,FALSE,6,1000,1,2088,17.82,High,0.348,6200,37200
"Meats, Fish & Eggs",TGFC Bombay Duck Whole Cleaned,31900,14,1,27400,500,FALSE,500,4500,1,250000,54.8,High,0.5,27400,13700000
"Meats, Fish & Eggs",Zorabian Pre Cut Chicken Skinless (Half),16500,0,1,16500,500,FALSE,500,0,1,250000,33,High,0.5,16500,8250000
"Meats, Fish & Eggs",Godrej Real Good Chicken Drumstick ,26500,9,2,23900,500,FALSE,500,2600,1,250000,47.8,High,0.5,23900,11950000
"Meats, Fish & Eggs",Suguna Active - DHA,7200,13,4,6200,348,FALSE,6,1000,1,2088,17.82,High,0.348,6200,37200
"Meats, Fish & Eggs",Godrej Real Good Chicken Marinated Lollipop ,20000,10,2,18000,580,FALSE,10,2000,1,5800,31.03,High,0.58,18000,180000
"Meats, Fish & Eggs",Godrej Yummiez Chicken Nuggets,32500,9,1,29300,500,FALSE,500,3200,1,250000,58.6,High,0.5,29300,14650000
"Meats, Fish & Eggs",Eastern Chicken Masala,7000,7,3,6500,100,FALSE,100,500,1,10000,65,High,0.1,6500,650000
"Meats, Fish & Eggs",Ching's Chicken Chilli Masala,1000,0,6,1000,20,FALSE,20,0,1,400,50,Low,0.02,1000,20000
"Meats, Fish & Eggs",Fresh Chicken Whole Leg - Skinless (Halal),16500,4,1,15700,500,FALSE,500,800,1,250000,31.4,High,0.5,15700,7850000
"Meats, Fish & Eggs",Ceres Foods Fish Mustard Instant Liquid Masala,22000,50,6,11000,200,FALSE,200,11000,1,40000,55,High,0.2,11000,2200000
"Meats, Fish & Eggs",TGFC Tilapia Curry Cut,25900,43,1,14700,500,FALSE,500,11200,1,250000,29.4,High,0.5,14700,7350000
"Meats, Fish & Eggs",Godrej Yummiez Chicken Lucknowi Seekh Kebab,26000,10,4,23400,400,FALSE,400,2600,1,160000,58.5,High,0.4,23400,9360000
"Meats, Fish & Eggs",Godrej Real Good Marinated Hot & Grill Chicken,24500,9,2,22100,450,FALSE,450,2400,1,202500,49.11,High,0.45,22100,9945000
"Meats, Fish & Eggs",Everest Meat Masala Powder,7400,9,3,6700,100,FALSE,100,700,1,10000,67,High,0.1,6700,670000
"Meats, Fish & Eggs",Suguna Heart- Omega3,7200,13,4,6200,348,FALSE,6,1000,1,2088,17.82,High,0.348,6200,37200
"Meats, Fish & Eggs",Everest Powder - Egg Curry Masala,4000,2,6,3900,50,FALSE,50,100,1,2500,78,High,0.05,3900,195000
"Meats, Fish & Eggs",TGFC Chicken Boneless Fresh Whole,26100,14,1,22200,500,FALSE,500,3900,1,250000,44.4,High,0.5,22200,11100000
"Meats, Fish & Eggs",Zorabian Chicken Smoked Ham,20500,5,1,19400,250,FALSE,250,1100,1,62500,77.6,High,0.25,19400,4850000
"Meats, Fish & Eggs",Suguna Fit Egg,12000,43,4,6800,348,FALSE,6,5200,1,2088,19.54,High,0.348,6800,40800
"Meats, Fish & Eggs",Everest Tandoori Chicken Masala,3900,2,5,3800,50,FALSE,50,100,1,2500,76,Medium,0.05,3800,190000
"Meats, Fish & Eggs",Godrej Yummiez Chilli Chicken Sausages ,16000,10,3,14400,250,FALSE,250,1600,1,62500,57.6,High,0.25,14400,3600000
"Meats, Fish & Eggs",Godrej Yummiez Chicken Punjabi Tikka ,29500,9,6,26600,360,FALSE,360,2900,1,129600,73.89,High,0.36,26600,9576000
"Meats, Fish & Eggs",Eastern Fish Masala,4800,2,5,4700,100,FALSE,100,100,1,10000,47,High,0.1,4700,470000
"Meats, Fish & Eggs",TGFC Catla Bengali Cut,29000,29,1,20400,500,FALSE,500,8600,1,250000,40.8,High,0.5,20400,10200000
"Meats, Fish & Eggs",Godrej Real Good Chicken Leg Boneless,27500,9,3,24800,450,FALSE,450,2700,1,202500,55.11,High,0.45,24800,11160000
"Meats, Fish & Eggs",TGFC Rohu Bengali Cut,24900,28,1,17900,500,FALSE,500,7000,1,250000,35.8,High,0.5,17900,8950000
"Meats, Fish & Eggs",Godrej Real Good Chicken Lollypop,17500,9,1,15800,580,FALSE,10,1700,1,5800,27.24,High,0.58,15800,158000
"Meats, Fish & Eggs",Godrej Real Good Chicken Liver Sealed ,7500,9,1,6800,200,FALSE,200,700,1,40000,34,High,0.2,6800,1360000
"Meats, Fish & Eggs",Everest Tandoori Chicken Masala,7400,9,3,6700,100,FALSE,100,700,1,10000,67,High,0.1,6700,670000
"Meats, Fish & Eggs",Fresh Mutton Mince - Kheema (Halal),51500,3,1,49500,500,FALSE,500,2000,1,250000,99,High,0.5,49500,24750000
"Meats, Fish & Eggs",Fresh Mutton Curry Cut Cubes (Halal),46500,4,1,44200,500,FALSE,500,2300,1,250000,88.4,High,0.5,44200,22100000
"Meats, Fish & Eggs",Ceres Foods Laal Maas Instant Liquid Masala,22000,50,5,11000,200,FALSE,200,11000,1,40000,55,High,0.2,11000,2200000
"Meats, Fish & Eggs",Godrej Real Good Chicken Legs ,21000,10,1,18900,116,FALSE,2,2100,1,232,162.93,High,0.116,18900,37800
"Meats, Fish & Eggs",Yummiez Chicken Breakfast Sausages,15000,0,3,15000,250,FALSE,250,0,1,62500,60,High,0.25,15000,3750000
"Meats, Fish & Eggs",TGFC Basa Fillets,32900,24,1,24700,500,FALSE,500,8200,1,250000,49.4,High,0.5,24700,12350000
"Meats, Fish & Eggs",Zorabian Chicken Legs Skinless,21000,0,1,21000,450,FALSE,450,0,1,202500,46.67,High,0.45,21000,9450000
"Meats, Fish & Eggs",Ceres Foods Nalli Nihari Instant Liquid Masala,22000,50,6,11000,200,FALSE,200,11000,1,40000,55,High,0.2,11000,2200000
"Meats, Fish & Eggs",Yummiez Chicken Garlic Fingers Pouch,25000,0,5,25000,400,FALSE,400,0,1,160000,62.5,High,0.4,25000,10000000
"Meats, Fish & Eggs",Suhana Spice Mix - Chicken Biryani,6600,0,6,6600,50,FALSE,50,0,1,2500,132,High,0.05,6600,330000
"Meats, Fish & Eggs",Suguna Nourish Egg,6200,0,0,6200,696,TRUE,12,0,0.9,8352,8.91,High,0.696,6200,74400
"Meats, Fish & Eggs",Fresh Chicken Curry Cut - Skinless (Halal),14000,0,0,14000,500,TRUE,500,0,1,250000,28,High,0.5,14000,7000000
"Meats, Fish & Eggs",Zorabian Chicken Breast Boneless ,14500,0,0,14500,450,TRUE,450,0,1,202500,32.22,High,0.45,14500,6525000
"Meats, Fish & Eggs",Zorabian Chicken Kheema Parathas,19000,0,0,19000,300,TRUE,300,0,1,90000,63.33,High,0.3,19000,5700000
"Meats, Fish & Eggs",Fresh Chicken Mince - Kheema (Halal),21500,5,0,20400,500,TRUE,500,1100,1,250000,40.8,High,0.5,20400,10200000
"Meats, Fish & Eggs",Godrej Real Good Chicken Boneless Cubes ,27500,9,0,24800,450,TRUE,450,2700,1,202500,55.11,High,0.45,24800,11160000
"Meats, Fish & Eggs",Suguna Vitamin D Egg,7500,17,0,6200,348,TRUE,6,1300,1,2088,17.82,High,0.348,6200,37200
"Meats, Fish & Eggs",Suguna Nourish Egg ,7200,16,0,6000,348,TRUE,6,1200,1,2088,17.24,High,0.348,6000,36000
"Meats, Fish & Eggs",Zorabian Chicken Mince,25000,0,0,25000,450,TRUE,450,0,1,202500,55.56,High,0.45,25000,11250000
"Meats, Fish & Eggs",Zorabian Chicken Leg Boneless ,25000,0,0,25000,450,TRUE,450,0,1,202500,55.56,High,0.45,25000,11250000
"Meats, Fish & Eggs",Godrej Yummiez Chicken Breakfast Salami,15000,4,0,14300,250,TRUE,250,700,1,62500,57.2,High,0.25,14300,3575000
"Meats, Fish & Eggs",Zorabian Chicken Cubes,27000,0,0,27000,500,TRUE,500,0,1,250000,54,High,0.5,27000,13500000
Biscuits,Britannia Good Day Cashew Cookies,1000,0,6,1000,60,FALSE,58,0,0.9,3480,16.67,Low,0.06,1000,58000
Biscuits,Britannia 50-50 Maska Chaska Biscuits,3200,3,6,3100,120,FALSE,120,100,1,14400,25.83,Medium,0.12,3100,372000
Biscuits,Dukes Waffy Chocolate Wafers,4500,51,4,2200,60,FALSE,75,2300,1,4500,36.67,High,0.06,2200,165000
Biscuits,Britannia Nutri Choice Digestive Biscuit,4500,0,1,4500,200,FALSE,150,0,1,30000,22.5,High,0.2,4500,675000
Biscuits,Britannia Goodday Chocochip Cookies,12000,17,5,9900,400,FALSE,400,2100,1,160000,24.75,High,0.4,9900,3960000
Biscuits,Britannia Good Day Pista Badam,4500,2,1,4400,200,FALSE,200,100,1,40000,22,High,0.2,4400,880000
Biscuits,Cadbury Chocobakes Chocolate Filled Cookies ,3000,0,5,3000,75,FALSE,75,0,1,5625,40,Medium,0.075,3000,225000
Biscuits,Dukes Waffy Strawberry Roll,15000,50,3,7500,250,FALSE,250,7500,1,62500,30,High,0.25,7500,1875000
Biscuits,Parle Monaco Classic Salty Biscuits,7000,0,4,7000,400,FALSE,400,0,0.9,160000,17.5,High,0.4,7000,2800000
Biscuits,Dukes Waffy Orange Wafers,4500,51,5,2200,60,FALSE,75,2300,1,4500,36.67,High,0.06,2200,165000
Biscuits,Britannia Good Day Pista Badam,2000,0,6,2000,100,FALSE,100,0,1,10000,20,Medium,0.1,2000,200000
Biscuits,Britannia Milk Bikis Biscuits Packet,2000,0,3,2000,200,FALSE,200,0,0.9,40000,10,Medium,0.2,2000,400000
Biscuits,Britannia Toastea (Premium Bake Rusk),6500,0,6,6500,400,FALSE,400,0,0.9,160000,16.25,High,0.4,6500,2600000
Biscuits,Dukes Waffy Strawberry Wafers,4500,51,2,2200,60,FALSE,75,2300,1,4500,36.67,High,0.06,2200,165000
Biscuits,Britannia Toastea Premium Bake Rusk,3500,0,3,3500,182,FALSE,182,0,0.9,33124,19.23,Medium,0.182,3500,637000
Biscuits,Lotte Choco Pie ,8000,10,3,7200,168,FALSE,168,800,1,28224,42.86,High,0.168,7200,1209600
Biscuits,Bauli Moonfils Choco Veg Puff Roll,1500,0,2,1500,45,FALSE,45,0,1,2025,33.33,Low,0.045,1500,67500
Biscuits,Sunfeast Dark Fantasy Choco Fills Cookies Packet,15000,15,3,12700,300,FALSE,300,2300,1,90000,42.33,High,0.3,12700,3810000
Biscuits,Britannia 50-50 Maska Chaska Biscuit,7500,10,6,6750,300,FALSE,300,750,1,90000,22.5,High,0.3,6750,2025000
Biscuits,Britannnia 50-50 Sweet & Salty Biscuit,2500,0,4,2500,200,FALSE,200,0,0.9,40000,12.5,Medium,0.2,2500,500000
Biscuits,Britannia Good Day Chunky Cookies,5000,15,6,4250,120,FALSE,120,750,1,14400,35.42,High,0.12,4250,510000
Biscuits,Sunfeast Marie Light,2300,13,1,2000,200,FALSE,200,300,0.9,40000,10,Medium,0.2,2000,400000
Biscuits,Britannia Bourbon Biscuit Buy 4 Get 1 Free,8000,10,2,7200,500,FALSE,500,800,0.9,250000,14.4,High,0.5,7200,3600000
Biscuits,The Bake Shop Whole Wheat Oats Khari,6500,6,5,6100,200,FALSE,200,400,1,40000,30.5,High,0.2,6100,1220000
Biscuits,Britannia Nutri Choice Oats Milk Almond Biscuit,2500,10,6,2250,75,FALSE,75,250,1,5625,30,Medium,0.075,2250,168750
Biscuits,Sunfeast Dark Fantasy Choco Creme,8000,27,4,5800,300,FALSE,300,2200,1,90000,19.33,High,0.3,5800,1740000
Biscuits,Lotte Choco Pie Chocolate Cake,2500,0,6,2500,56,FALSE,56,0,1,3136,44.64,Medium,0.056,2500,140000
Biscuits,Sunfeast Mom's Magic Cashew & Almond Cookies Packet,3000,10,3,2700,200,FALSE,200,300,0.9,40000,13.5,Medium,0.2,2700,540000
Biscuits,Unibic SugarFree - Oatmeal Cookies,5000,16,3,4200,75,FALSE,75,800,1,5625,56,High,0.075,4200,315000
Biscuits,Parle Hide & Seek Cookies With Added Almonds,3000,3,1,2900,100,FALSE,100,100,1,10000,29,Medium,0.1,2900,290000
Biscuits,Unibic Fruit & Nut Cookies,2500,8,3,2300,67,FALSE,67,200,1,4489,34.33,Medium,0.067,2300,154100
Biscuits,Sunfeast Yumfills Whoopie Pie,14000,25,5,10500,253,FALSE,276,3500,1,69828,41.5,High,0.253,10500,2898000
Biscuits,Britannia Toastea Premium Bake Rusk,11000,14,1,9400,700,FALSE,700,1600,0.9,490000,13.43,High,0.7,9400,6580000
Biscuits,McVitie's Marie biscuits with Goodness of Calcium,3000,0,6,3000,250,FALSE,250,0,0.9,62500,12,Medium,0.25,3000,750000
Biscuits,Britannia Treat Croissant Vanilla Creme Roll,2000,10,2,1800,47,FALSE,47,200,1,2209,38.3,Medium,0.047,1800,84600
Biscuits,Unibic Honey Oatmeal Cookies,2500,8,6,2300,75,FALSE,75,200,1,5625,30.67,Medium,0.075,2300,172500
Biscuits,Britannia Good Day Choco Chip Cookies,3000,3,6,2900,100,FALSE,100,100,1,10000,29,Medium,0.1,2900,290000
Biscuits,The Bake Shop Masala Cheese Crackers,9500,6,3,8900,100,FALSE,100,600,1,10000,89,High,0.1,8900,890000
Biscuits,Britannia Pure Magic Vanilla Creme Biscuit,3500,17,4,2900,100,FALSE,100,600,1,10000,29,Medium,0.1,2900,290000
Biscuits,Open Secret Assorted Story Box,10500,22,4,8100,75,FALSE,75,2400,1,5625,108,High,0.075,8100,607500
Biscuits,Cadbury Oreo Dipped Biscuit,7000,10,1,6300,150,FALSE,150,700,1,22500,42,High,0.15,6300,945000
Biscuits,Sunfeast Farmlite Oats & Almonds Biscuits Packet,6000,10,3,5400,150,FALSE,150,600,1,22500,36,High,0.15,5400,810000
Biscuits,Unibic SugarFree - Butter Cookies,5000,16,6,4200,75,FALSE,75,800,1,5625,56,High,0.075,4200,315000
Biscuits,Britannia Good Day Cashew Cookies Packet,12000,12,6,10560,600,FALSE,600,1440,1,360000,17.6,High,0.6,10560,6336000
Biscuits,Dukes Sour & Cream Onion Nibbles Baked,5500,25,3,4100,150,FALSE,150,1400,1,22500,27.33,High,0.15,4100,615000
Biscuits,Britannia Treat Croissant Vanilla Creme Roll,2000,0,6,2000,47,FALSE,47,0,1,2209,42.55,Medium,0.047,2000,94000
Biscuits,Parle Hide & Seek Choco Rolls,5000,2,4,4900,120,FALSE,120,100,1,14400,40.83,High,0.12,4900,588000
Biscuits,Britannia Treat Creme Wafers - Vanilla,4500,11,6,4000,60,FALSE,1,500,1,60,66.67,High,0.06,4000,4000
Biscuits,Parle Rusk Elaichi,4800,2,6,4700,300,FALSE,300,100,0.9,90000,15.67,High,0.3,4700,1410000
Biscuits,Lotte Choco Pie ,14000,6,2,13100,336,FALSE,336,900,1,112896,38.99,High,0.336,13100,4401600
Biscuits,Sunfeast Mom's Magic Cashew & Almond Biscuits,12000,15,6,10200,600,FALSE,600,1800,1,360000,17,High,0.6,10200,6120000
Biscuits,Unibic Cashew Cookies,2500,8,6,2300,75,FALSE,75,200,1,5625,30.67,Medium,0.075,2300,172500
Biscuits,Parle Monaco Jeffs Zeera Biscuit,6000,10,4,5400,200,FALSE,200,600,1,40000,27,High,0.2,5400,1080000
Biscuits,"Unibic Snack Bar - Multigrain, Choco",4000,17,6,3300,30,FALSE,30,700,1,900,110,High,0.03,3300,99000
Biscuits,The Bake Shop Methi Khari Simply Delicious,6500,6,2,6100,200,FALSE,200,400,1,40000,30.5,High,0.2,6100,1220000
Biscuits,Britannia Treat Jimjam Family Pack (Buy 4 Get 1 Free),10000,0,6,10000,500,FALSE,500,0,1,250000,20,High,0.5,10000,5000000
Biscuits,Open Secret Choco Almond Tiffin Pack,3500,22,3,2700,25,FALSE,25,800,1,625,108,Medium,0.025,2700,67500
Biscuits,Lotte Choco Pie ,15000,20,6,12000,696,FALSE,12,3000,1,8352,17.24,High,0.696,12000,144000
Biscuits,Baker Street Suji Rusk Large Pack,3000,10,6,2700,200,FALSE,200,300,0.9,40000,13.5,Medium,0.2,2700,540000
Biscuits,Parle Hide & Seek Choco Rolls,3000,0,1,3000,75,FALSE,75,0,1,5625,40,Medium,0.075,3000,225000
Biscuits,Sunfeast Dark Fantasy Vanilla Creme,8000,15,6,6800,300,FALSE,300,1200,1,90000,22.67,High,0.3,6800,2040000
Biscuits,Britannia Treat Burst Choco Creme Fills,3000,0,3,3000,120,FALSE,120,0,1,14400,25,Medium,0.12,3000,360000
Biscuits,Parle Milano Mixed Berries Cookies,3500,2,3,3400,75,FALSE,75,100,1,5625,45.33,Medium,0.075,3400,255000
Biscuits,Karachi Bakery Cashew Biscuits ,21000,5,4,19900,400,FALSE,400,1100,1,160000,49.75,High,0.4,19900,7960000
Biscuits,Britannia Pure Magic Choco Lush Cookies,12000,20,4,9600,300,FALSE,300,2400,1,90000,32,High,0.3,9600,2880000
Biscuits,Britannia Treart Creme Wafers Chocolate,4500,11,6,4000,60,FALSE,1,500,1,60,66.67,High,0.06,4000,4000
Biscuits,Unibic Daily Digestive (Multigrain Cookies),3000,6,6,2800,75,FALSE,75,200,1,5625,37.33,Medium,0.075,2800,210000
Biscuits,Cadbury Chocobakes Choc Filled Cookies,6000,0,6,6000,150,FALSE,150,0,1,22500,40,High,0.15,6000,900000
Biscuits,The Bake Shop Whole Wheat Multigrain Toast (Rusk),6000,6,2,5600,200,FALSE,200,400,1,40000,28,High,0.2,5600,1120000
Biscuits,Unibic Choco Kiss Cookies,4500,15,5,3800,75,FALSE,75,700,1,5625,50.67,High,0.075,3800,285000
Biscuits,Britannia Treat Creme Wafers - Orange,4500,11,6,4000,60,FALSE,60,500,1,3600,66.67,High,0.06,4000,240000
Biscuits,Bauli Moonfills Pack of 4,6000,10,6,5400,180,FALSE,190,600,1,34200,30,High,0.18,5400,1026000
Biscuits,Unibic Oatmeal Digestive Cookies ,5000,6,6,4700,150,FALSE,150,300,1,22500,31.33,High,0.15,4700,705000
Biscuits,Orion Choco Pie - Chocolate Coated Soft Biscuit,15000,25,2,11200,336,FALSE,336,3800,1,112896,33.33,High,0.336,11200,3763200
Biscuits,Britannia Good Day Cashew Cookies Pack Of 6,12000,10,6,10800,120,FALSE,120,1200,1,14400,90,High,0.12,10800,1296000
Biscuits,Parle Fab Bourbon,3000,0,3,3000,150,FALSE,150,0,1,22500,20,Medium,0.15,3000,450000
Biscuits,Open Secret White Choco Tiffin Pack,3500,22,1,2700,25,FALSE,25,800,1,625,108,Medium,0.025,2700,67500
Biscuits,The Bake Shop Whole Wheat Bread Sticks,6000,6,1,5600,100,FALSE,100,400,1,10000,56,High,0.1,5600,560000
Biscuits,Unibic Assorted Cookies ,14900,8,6,13700,450,FALSE,450,1200,1,202500,30.44,High,0.45,13700,6165000
Biscuits,The Bake Shop Milk & Raisin Toast (Rusk),6000,6,4,5600,200,FALSE,200,400,1,40000,28,High,0.2,5600,1120000
Biscuits,Lotte Choco Pie Cocoa Pie,9000,10,6,8100,168,FALSE,168,900,1,28224,48.21,High,0.168,8100,1360800
Biscuits,Bauli Moonfils Veg - Strawberry,1500,0,5,1500,45,FALSE,47,0,1,2115,33.33,Low,0.045,1500,70500
Biscuits,The Bake Shop Masala Lavash,7500,6,6,7000,100,FALSE,200,500,1,20000,70,High,0.1,7000,1400000
Biscuits,Britannia Good Day Nut Cookies,3000,0,6,3000,120,FALSE,120,0,1,14400,25,Medium,0.12,3000,360000
Biscuits,Sunfeast Mom's Magic Rich Butter Cookies,3000,10,6,2700,200,FALSE,200,300,0.9,40000,13.5,Medium,0.2,2700,540000
Biscuits,The Bake Shop Whole Wheat Toast (Rusk) ,6000,6,4,5600,200,FALSE,200,400,1,40000,28,High,0.2,5600,1120000
Biscuits,Open Secret Peanut Butter Story Box,10500,22,6,8100,75,FALSE,75,2400,1,5625,108,High,0.075,8100,607500
Biscuits,Open Secret White Choco Story Box,10500,22,6,8100,75,FALSE,75,2400,1,5625,108,High,0.075,8100,607500
Biscuits,The Bake Shop Whole Wheat Multigrain Lavash,7500,6,3,7000,100,FALSE,200,500,1,20000,70,High,0.1,7000,1400000
Biscuits,McVitie's Oat Cookies,4500,0,2,4500,120,FALSE,120,0,1,14400,37.5,High,0.12,4500,540000
Biscuits,Britannia Tiger Krunch Biscuits,12000,0,4,12000,400,FALSE,400,0,1,160000,30,High,0.4,12000,4800000
Biscuits,McVitie's Butter Cookies,3000,10,6,2700,200,FALSE,200,300,0.9,40000,13.5,Medium,0.2,2700,540000
Biscuits,Bauli Moonfils Strawberry,1500,0,5,1500,45,FALSE,45,0,1,2025,33.33,Low,0.045,1500,67500
Biscuits,Britannia Good Day Butter Cookies,8000,10,6,7200,600,FALSE,600,800,0.9,360000,12,High,0.6,7200,4320000
Biscuits,Parle Hide & Seek Choco Rolls,6000,0,1,6000,120,FALSE,120,0,1,14400,50,High,0.12,6000,720000
Biscuits,The Bake Shop Jeera Ajwain Bread Sticks,6000,6,6,5600,100,FALSE,100,400,1,10000,56,High,0.1,5600,560000
Biscuits,Parle Fab!o Vanilla Creme Sandwich Biscuit,3000,3,6,2900,120,FALSE,120,100,1,14400,24.17,Medium,0.12,2900,348000
Biscuits,Sunfeast Farmlite Nuts Digestive,7000,11,6,6200,250,FALSE,250,800,1,62500,24.8,High,0.25,6200,1550000
Biscuits,Britannia Pure Magic - Chocolush,3500,2,6,3400,100,FALSE,100,100,1,10000,34,Medium,0.1,3400,340000
Biscuits,The Bake Shop Maska & Multigrain Cheese Crackers,13000,10,3,11600,100,FALSE,150,1400,1,15000,116,High,0.1,11600,1740000
Biscuits,Britannia Nutri Choice Ragi Cookies,7000,10,6,6300,150,FALSE,150,700,1,22500,42,High,0.15,6300,945000
Biscuits,Sunfeast Farmlite 5 Seed Digestive,6000,0,2,6000,250,FALSE,250,0,1,62500,24,High,0.25,6000,1500000
Biscuits,Dukes Nibbles - Ranch Crackers,5000,0,6,5000,150,FALSE,150,0,1,22500,33.33,High,0.15,5000,750000
Biscuits,Danish Butter Cookies,35000,0,1,35000,400,FALSE,400,0,1,160000,87.5,High,0.4,35000,14000000
Biscuits,The Bake Shop Sesame Seed Crackers,13000,10,4,11600,100,FALSE,150,1400,1,15000,116,High,0.1,11600,1740000
Biscuits,Good Day Butter Cookies,1000,0,0,1000,75,TRUE,75,0,0.9,5625,13.33,Low,0.075,1000,75000
Biscuits,Britannia Marie Gold Biscuits Packet,3000,0,0,3000,250,TRUE,250,0,0.9,62500,12,Medium,0.25,3000,750000
Biscuits,Britannia Good Day Cashew Cookies,2000,0,0,2000,100,TRUE,100,0,1,10000,20,Medium,0.1,2000,200000
Biscuits,Sunfeast Dark Fantasy Choco Fills,3500,8,0,3200,75,TRUE,75,300,1,5625,42.67,Medium,0.075,3200,240000
Biscuits,Britannia Nutri Choice Digestive Biscuits Packet,2500,0,0,2500,100,TRUE,100,0,1,10000,25,Medium,0.1,2500,250000
Biscuits,Britannia Classic Little Hearts ,2500,0,0,2500,75,TRUE,75,0,1,5625,33.33,Medium,0.075,2500,187500
Biscuits,Britannia Good Day Cashew Cookies Packet,4000,5,0,3800,200,TRUE,200,200,1,40000,19,High,0.2,3800,760000
Biscuits,Britannia Nice Time Biscuit,2500,0,0,2500,150,TRUE,150,0,0.9,22500,16.67,Medium,0.15,2500,375000
Biscuits,Britannia Milk Bikis Cream Biscuit,4500,0,0,4500,200,TRUE,200,0,1,40000,22.5,High,0.2,4500,900000
Biscuits,Britannia Bourbon Chocolate Cream Biscuits,3500,2,0,3400,150,TRUE,150,100,1,22500,22.67,Medium,0.15,3400,510000
Biscuits,Dukes Waffy Chocolate Wafer Rolls ,15000,50,0,7500,250,TRUE,250,7500,1,62500,30,High,0.25,7500,1875000
Biscuits,Britannia Milk Bikis Milky Sandwich,2500,0,0,2500,120,TRUE,120,0,1,14400,20.83,Medium,0.12,2500,300000
Biscuits,Britannia Marie Gold Biscuit,2800,0,0,2800,200,TRUE,200,0,0.9,40000,14,Medium,0.2,2800,560000
Biscuits,Britannia Marie Gold (Buy 4 Get 1 Free),8000,0,0,8000,600,TRUE,600,0,0.9,360000,13.33,High,0.6,8000,4800000
Biscuits,Britannia 50-50 Maska Chaska Biscuit,1000,0,0,1000,46,TRUE,45,0,1,2070,21.74,Low,0.046,1000,45000
Biscuits,Unibic Choco Nut Cookies,2500,8,0,2300,75,TRUE,75,200,1,5625,30.67,Medium,0.075,2300,172500
Biscuits,Britannia Vita Marie Gold Biscuit,4500,0,0,4500,300,TRUE,300,0,0.9,90000,15,High,0.3,4500,1350000
Biscuits,The Bake Shop Maska Khari,6500,6,0,6100,200,TRUE,100,400,1,20000,30.5,High,0.2,6100,610000
Biscuits,Parle Fab! Jam-In Cream Filled ,3500,2,0,3400,150,TRUE,150,100,1,22500,22.67,Medium,0.15,3400,510000
Biscuits,Sunfeast Nice Biscuit,2500,12,0,2200,150,TRUE,150,300,0.9,22500,14.67,Medium,0.15,2200,330000
Biscuits,Britannia Nutrichoice 5 Grain Digestive Biscuits,7500,0,0,7500,200,TRUE,200,0,1,40000,37.5,High,0.2,7500,1500000
Biscuits,Cadbury Oreo Strawberry Bicuits,3000,3,0,2900,120,TRUE,120,100,1,14400,24.17,Medium,0.12,2900,348000
Biscuits,Sunfeast Mom's Magic Cashew & Almond Biscuit,1000,0,0,1000,60,TRUE,60,0,0.9,3600,16.67,Low,0.06,1000,60000
Biscuits,Britannia Roll Yo! Strawberry Swiss Roll,1000,0,0,1000,28,TRUE,28,0,1,784,35.71,Low,0.028,1000,28000
Biscuits,Bauli Moonfils Choco Cream (With Egg),1500,0,0,1500,45,TRUE,45,0,1,2025,33.33,Low,0.045,1500,67500
Biscuits,Britannia Nutri Choice Oats Choco Almond Biscuit,2500,10,0,2250,100,TRUE,75,250,1,7500,22.5,Medium,0.1,2250,168750
Biscuits,Britannia Nutri Choice Cracker Sugar Free Biscuit,3500,0,0,3500,300,TRUE,300,0,0.9,90000,11.67,Medium,0.3,3500,1050000
Biscuits,Cadbury Oreo Chocolatey Sandwich Biscuits Family Pack,8000,0,0,8000,300,TRUE,300,0,1,90000,26.67,High,0.3,8000,2400000
Biscuits,Bauli Moonfils Orange Puff Roll,1500,0,0,1500,45,TRUE,45,0,1,2025,33.33,Low,0.045,1500,67500
Biscuits,Britannia Treat Jimjam Cream Biscuits ,2500,0,0,2500,100,TRUE,100,0,1,10000,25,Medium,0.1,2500,250000
Biscuits,Britannia Toastea Premium Bake Rusk,5000,6,0,4700,300,TRUE,300,300,0.9,90000,15.67,High,0.3,4700,1410000
Biscuits,The Bake Shop Jeera Khari,6500,0,0,6500,200,TRUE,200,0,1,40000,32.5,High,0.2,6500,1300000
Biscuits,"Cadbury Oreo Creme Biscuit - Vanilla, Original 120 g",3000,3,0,2900,120,TRUE,120,100,1,14400,24.17,Medium,0.12,2900,348000
Biscuits,Britannia Good Day Cashew Cookies,23000,25,0,17200,1000,TRUE,1,5800,1,1000,17.2,High,1,17200,17200
Biscuits,Bauli Moonfils - Vanilla,1500,0,0,1500,45,TRUE,45,0,1,2025,33.33,Low,0.045,1500,67500
Biscuits,Britannia Roll Yo! Choco Swiss Roll (With Egg),1000,0,0,1000,28,TRUE,28,0,1,784,35.71,Low,0.028,1000,28000
Biscuits,Britannia Milk Bikis Cream Biscuit,7000,0,0,7000,500,TRUE,500,0,0.9,250000,14,High,0.5,7000,3500000
Biscuits,Open Secret Choco Almond Story Box,10500,22,0,8100,75,TRUE,75,2400,1,5625,108,High,0.075,8100,607500
Biscuits,Parle Monaco Sixer Salted Biscuits ,6000,10,0,5400,200,TRUE,200,600,1,40000,27,High,0.2,5400,1080000
Biscuits,Sunfeast Dark Fantasy Bourbon Bliss,3500,17,0,2900,150,TRUE,150,600,1,22500,19.33,Medium,0.15,2900,435000
Biscuits,Patanjali Atta Doodh Rusk,4000,0,0,4000,300,TRUE,300,0,0.9,90000,13.33,High,0.3,4000,1200000
Biscuits,Sunfeast Dark Fantasy Bourbon Bliss,3500,0,0,3500,150,TRUE,150,0,1,22500,23.33,Medium,0.15,3500,525000
Personal Care,Clove Sensitive Toothpaste with Anti-Sensitivity & Fluoride Formulation,16000,35,3,10400,80,FALSE,80,5600,1,6400,130,High,0.08,10400,832000
Personal Care,Dettol Original Germ Protection Alcohol Based Hand Sanitizer,2500,0,6,2500,50,FALSE,50,0,1,2500,50,Medium,0.05,2500,125000
Personal Care,Colgate Visible White Toothpaste,11500,10,6,10300,100,FALSE,100,1200,1,10000,103,High,0.1,10300,1030000
Personal Care,Dettol SKincare Handwash Value Refill,10900,3,6,10500,750,FALSE,750,400,0.9,562500,14,High,0.75,10500,7875000
Personal Care,Savlon Herbal Sensitive Liquid Handwash Refill Pouch,11500,4,6,11000,750,FALSE,500,500,0.9,375000,14.67,High,0.75,11000,5500000
Personal Care,Colgate Total 12 Whole Mouth Protection Toothpaste,12000,10,6,10800,120,FALSE,120,1200,1,14400,90,High,0.12,10800,1296000
Personal Care,Lux International Creamy White Soap Bar,3500,2,6,3400,75,FALSE,75,100,1,5625,45.33,Medium,0.075,3400,255000
Personal Care,Colgate Herbal Toothpaste,11400,18,2,9300,200,FALSE,200,2100,1,40000,46.5,High,0.2,9300,1860000
Personal Care,Nivea Men Deodorant Fresh Active 48h Long lasting Freshness,22500,24,6,16900,150,FALSE,150,5600,1,22500,112.67,High,0.15,16900,2535000
Personal Care,Dabur Meswak Toothpaste,5800,5,6,5500,100,FALSE,100,300,1,10000,55,High,0.1,5500,550000
Personal Care,Colgate Max Fresh Cooling Crystals Toothpaste,10100,5,2,9500,150,FALSE,150,600,1,22500,63.33,High,0.15,9500,1425000
Personal Care,Indulekha Bhringa Hair Oil,43200,15,6,36700,100,FALSE,100,6500,1,10000,367,High,0.1,36700,3670000
Personal Care,Colgate Sensitive Soft Bristles Toothbrush,5000,0,6,5000,58,FALSE,1,0,1,58,86.21,High,0.058,5000,5000
Personal Care,Pears Pure & Gentle Glycerin Bath Soap,7500,0,6,7500,125,FALSE,125,0,1,15625,60,High,0.125,7500,937500
Personal Care,Vaseline Skin Protecting Jelly,7900,13,6,6800,50,FALSE,50,1100,1,2500,136,High,0.05,6800,340000
Personal Care,Dettol Original Germ Protection Bathing Soap Bar,16600,5,4,15700,375,FALSE,375,900,1,140625,41.87,High,0.375,15700,5887500
Personal Care,Dettol Intense Cool Soap (B4G1),26000,5,6,24700,625,FALSE,625,1300,1,390625,39.52,High,0.625,24700,15437500
Personal Care,Livon Anti-Frizz Serum,25000,10,3,22500,100,FALSE,100,2500,1,10000,225,High,0.1,22500,2250000
Personal Care,Lifebuoy Germ Protection Care Soap Bar,3000,3,3,2900,100,FALSE,125,100,1,12500,29,Medium,0.1,2900,362500
Personal Care,Lux International Creamy White Soap Bar,7000,10,6,6300,125,FALSE,125,700,1,15625,50.4,High,0.125,6300,787500
Personal Care,Godrej Nupur  100% Pure Henna (Mehendi),1000,0,6,1000,18,FALSE,18,0,1,324,55.56,Low,0.018,1000,18000
Personal Care,Glow & Lovely Advanced Multivitamin Face Cream,21300,10,6,19000,110,FALSE,110,2300,1,12100,172.73,High,0.11,19000,2090000
Personal Care,Set Wet Style Vertical Hold Hair Gel,5000,10,4,4500,50,FALSE,50,500,1,2500,90,High,0.05,4500,225000
Personal Care,"Godrej Expert Rich Crème, Natural Black",3000,0,6,3000,20,FALSE,20,0,1,400,150,Medium,0.02,3000,60000
Personal Care,Nycil Germ Expert Cool Herbal Talc,13000,8,1,11900,150,FALSE,200,1100,1,30000,79.33,High,0.15,11900,2380000
Personal Care,Godrej Expert Creme Hair Natural Brown Colour ,3000,0,6,3000,20,FALSE,20,0,1,400,150,Medium,0.02,3000,60000
Personal Care,Veet Sensitive Skin Hair Removal Cream,13500,5,6,12800,50,FALSE,50,700,1,2500,256,High,0.05,12800,640000
Personal Care,Closeup Everfresh+ Anti-Germ Gel Toothpaste Red Hot,5000,2,1,4900,80,FALSE,80,100,1,6400,61.25,High,0.08,4900,392000
Personal Care,Pears Pure And Gentle Value Pack Of 3 Bathing Soap,19900,6,5,18600,375,FALSE,375,1300,1,140625,49.6,High,0.375,18600,6975000
Personal Care,Gillette Presto Ready Shaver 5 Cartridges ,8800,6,6,8200,290,FALSE,5,600,1,1450,28.28,High,0.29,8200,41000
Personal Care,Closeup Everfresh+ Anti-Germ Gel Toothpaste Red Hot,16000,10,4,14400,300,FALSE,300,1600,1,90000,48,High,0.3,14400,4320000
Personal Care,"Godrej Expert Rich Crème, Dark Brown",3000,0,4,3000,20,FALSE,20,0,1,400,150,Medium,0.02,3000,60000
Personal Care,Nivea Soft Light Moisturizer for Face Hand & Body Non-Sticky Cream with Vitamin E & Jojoba Oil ,18500,15,3,15700,100,FALSE,100,2800,1,10000,157,High,0.1,15700,1570000
Personal Care,Fiama Gel Bar Celebration Pack Buy 4 Get 1 Free,29000,10,6,26100,625,FALSE,625,2900,1,390625,41.76,High,0.625,26100,16312500
Personal Care,Gillette Sensitive Shaving Foam,22500,6,4,21000,418,FALSE,418,1500,1,174724,50.24,High,0.418,21000,8778000
Personal Care,Dove Hair Fall Rescue Shampoo,15000,6,5,14100,180,FALSE,180,900,1,32400,78.33,High,0.18,14100,2538000
Personal Care,Gillette Mach 3 Mens Razor Blades,49900,7,4,46000,232,FALSE,4,3900,1,928,198.28,High,0.232,46000,184000
Personal Care,Palmolive Aroma Absolute Relax Shower Gel,19900,20,2,15900,250,FALSE,250,4000,1,62500,63.6,High,0.25,15900,3975000
Personal Care,Godrej Protekt Germ Fighter Handwash,9900,0,6,9900,750,FALSE,750,0,0.9,562500,13.2,High,0.75,9900,7425000
Personal Care,Dettol Hand Sanitizer,10000,5,6,9500,200,FALSE,200,500,1,40000,47.5,High,0.2,9500,1900000
Personal Care,Dabur Amla Hair Oil,8800,0,2,8800,180,FALSE,180,0,1,32400,48.89,High,0.18,8800,1584000
Personal Care,Dettol Original Liquid Handwash,8900,4,6,8500,200,FALSE,200,400,1,40000,42.5,High,0.2,8500,1700000
Personal Care,L'Oreal Paris Total Repair 5 Conditioner,19900,0,6,19900,192,FALSE,180,0,1,34560,103.65,High,0.192,19900,3582000
Personal Care,Patanjali Saundarya Aloe Vera Gel,9000,0,5,9000,150,FALSE,150,0,1,22500,60,High,0.15,9000,1350000
Personal Care,Head & Shoulders 2 In 1 Anti Dandruff Shampoo Conditioner ,19500,10,4,17400,180,FALSE,180,2100,1,32400,96.67,High,0.18,17400,3132000
Personal Care,Clean & Clear Pimple Clearing Face Wash,13000,10,2,11700,80,FALSE,80,1300,1,6400,146.25,High,0.08,11700,936000
Personal Care,Himalaya Anti Dandruff Shampoo,14000,8,2,12800,200,FALSE,200,1200,1,40000,64,High,0.2,12800,2560000
Personal Care,Stayfree Secure Dry Cover Regular Sanitary Pad With Wings,3000,3,6,2900,406,FALSE,7,100,0.9,2842,7.14,Medium,0.406,2900,20300
Personal Care,Savlon Moisture Shield Hand Wash,9900,4,6,9500,750,FALSE,750,400,0.9,562500,12.67,High,0.75,9500,7125000
Personal Care,Dove Intense Repair Conditioner,19000,14,6,16200,175,FALSE,80,2800,1,14000,92.57,High,0.175,16200,1296000
Personal Care,Dabur Gulabari Rose Glow Face Cleanse,7500,5,4,7100,100,FALSE,100,400,1,10000,71,High,0.1,7100,710000
Personal Care,Parachute Jasmine Hair Oil,8200,9,6,7400,190,FALSE,190,800,1,36100,38.95,High,0.19,7400,1406000
Personal Care,Johnson's Baby Skincare Wipes,7900,6,6,7400,1160,FALSE,20,500,0.9,23200,6.38,High,1.16,7400,148000
Personal Care,Dettol Skincare Liquid Hand Wash,7900,0,6,7900,200,FALSE,200,0,1,40000,39.5,High,0.2,7900,1580000
Personal Care,Old Spice Original Lather Shaving Cream,7500,9,6,6800,70,FALSE,70,700,1,4900,97.14,High,0.07,6800,476000
Personal Care,Veet Hair Removal Cream Dry Skin,13500,5,5,12800,50,FALSE,50,700,1,2500,256,High,0.05,12800,640000
Personal Care,L'Oreal Paris Total Repair 5 Shampoo,26500,0,2,26500,396,FALSE,360,0,1,142560,66.92,High,0.396,26500,9540000
Personal Care,Fiama Menthol & Magnolia Cooling Gel Bar Soap,16000,11,6,14100,375,FALSE,375,1900,1,140625,37.6,High,0.375,14100,5287500
Personal Care,Nivea Lip Balm Original Care for 24h Moisture with Shea Butter & Natural Oils,14000,15,6,11900,5,FALSE,4,2100,1,20,2380,High,0.005,11900,47600
Personal Care,Oral-B Charcoal Deep Clean Stain Removal Toothbrush Soft,9900,0,3,9900,232,FALSE,4,0,1,928,42.67,High,0.232,9900,39600
Personal Care,Neutrogena Ultra Sheer Dry Touch SPF 50+ Sunblock Sunscreen Lotion,25000,10,3,22500,30,FALSE,30,2500,1,900,750,High,0.03,22500,675000
Personal Care,Clinic Plus Strong & Long Health Shampoo,49900,10,3,44900,650,FALSE,650,5000,1,422500,69.08,High,0.65,44900,29185000
Personal Care,Johnson's Baby No More Tears Baby Shampoo,9800,0,5,9800,100,FALSE,100,0,1,10000,98,High,0.1,9800,980000
Personal Care,Colgate Zig Zag Toothbrush,12000,0,3,12000,348,FALSE,6,0,1,2088,34.48,High,0.348,12000,72000
Personal Care,Savlon Moisture Shield Germ Protection Handwash Refill (Buy 1 Get 1 Free),18900,0,6,18900,1500,FALSE,1500,0,0.9,2250000,12.6,High,1.5,18900,28350000
Personal Care,Colgate Sensitive Everyday Protection Anticavity Toothpaste,7500,0,6,7500,40,FALSE,40,0,1,1600,187.5,High,0.04,7500,300000
Personal Care,Whisper Ultra Soft XL+ Sanitary Pads,33000,2,6,32300,30,FALSE,30,700,1,900,1076.67,High,0.03,32300,969000
Personal Care,Garnier Colour Naturals Hair Colour - 1 Natural Black,8000,0,1,8000,60,FALSE,60,0,1,3600,133.33,High,0.06,8000,480000
Personal Care,Axe Pulse Men's Deodorant,21000,0,6,21000,150,FALSE,150,0,1,22500,140,High,0.15,21000,3150000
Personal Care,Colgate Zigzag Charcoal Soft Bristle Toothbrush - 4 Pcs,9900,0,6,9900,232,FALSE,4,0,1,928,42.67,High,0.232,9900,39600
Personal Care,Whisper Ultra Clean Wings XL+  Pouch,44900,7,6,41500,44,FALSE,44,3400,1,1936,943.18,High,0.044,41500,1826000
Personal Care,Whisper Choice Regular Sanitary Pads,9000,0,6,9000,1160,FALSE,20,0,0.9,23200,7.76,High,1.16,9000,180000
Personal Care,Axe Dark Temptation Men's Deodorant,21000,7,5,19400,150,FALSE,150,1600,1,22500,129.33,High,0.15,19400,2910000
Personal Care,Head & Shoulders Anti-Dandruff Smooth & Silky Shampoo,15000,0,4,15000,180,FALSE,180,0,1,32400,83.33,High,0.18,15000,2700000
Personal Care,Clinic Plus Strength & Shine Shampoo With Egg Protein ,10500,0,2,10500,175,FALSE,175,0,1,30625,60,High,0.175,10500,1837500
Personal Care,Engage M1 Perfume Spray for Men ,21000,7,6,19400,120,FALSE,120,1600,1,14400,161.67,High,0.12,19400,2328000
Personal Care,Tresemme Keratin Smooth Conditioner,38000,0,3,38000,340,FALSE,340,0,1,115600,111.76,High,0.34,38000,12920000
Personal Care,"Garnier Color Naturals Crème Hair Color, Shade 5 Light Brown",18000,0,1,18000,100,FALSE,100,0,1,10000,180,High,0.1,18000,1800000
Personal Care,Origami Aloe Vera Wipes,7500,13,4,6500,25,FALSE,25,1000,1,625,260,High,0.025,6500,162500
Personal Care,"Engage Drizzle Deodorant For Women, Floral And Lavender, Skin Friendly",19500,10,6,17400,150,FALSE,150,2100,1,22500,116,High,0.15,17400,2610000
Personal Care,Gellette Presto Ready Shaver,2000,0,1,2000,58,FALSE,1,0,1,58,34.48,Medium,0.058,2000,2000
Personal Care,Colgate Max Fresh Plax Mouthwash - Fresh Mint,15000,20,5,12000,250,FALSE,250,3000,1,62500,48,High,0.25,12000,3000000
Personal Care,Colgate Zig Zag Charcoal Medium Toothbrush 4 Pcs,9900,0,6,9900,232,FALSE,4,0,1,928,42.67,High,0.232,9900,39600
Personal Care,Godrej Protekt,9900,0,3,9900,750,FALSE,750,0,0.9,562500,13.2,High,0.75,9900,7425000
Personal Care,Colgate Total Charcoal Anticavity Toothpaste,11000,10,3,9900,120,FALSE,120,1100,1,14400,82.5,High,0.12,9900,1188000
Personal Care,Colgate Kids 0-2 Extra Soft Tooth Brush,3000,16,6,2500,58,FALSE,1,500,1,58,43.1,Medium,0.058,2500,2500
Personal Care,Gillete Mach3 ,26000,10,6,23400,116,FALSE,2,2600,1,232,201.72,High,0.116,23400,46800
Personal Care,Maybelline New York Colossal Kajal Black,14900,0,2,14900,0,FALSE,0,0,1,0,#DIV/0!,High,0,14900,0
Personal Care,Godrej Cinthol Lime Talc,5500,0,3,5500,100,FALSE,100,0,1,10000,55,High,0.1,5500,550000
Personal Care,Hamam Soap Bar Neem Tulsi and Aloe Vera,5800,0,6,5800,150,FALSE,150,0,1,22500,38.67,High,0.15,5800,870000
Personal Care,"Godrej Expert Rich Crème, Burgundy",3300,0,6,3300,20,FALSE,20,0,1,400,165,Medium,0.02,3300,66000
Personal Care,Colgate Gentle Sensitive+ Toothbrush Pack Of 4,12000,10,4,10800,232,FALSE,4,1200,1,928,46.55,High,0.232,10800,43200
Personal Care,Nivea Creme All Season Multi-Purpose Cream ,17500,10,4,15700,100,FALSE,100,1800,1,10000,157,High,0.1,15700,1570000
Personal Care,Oral-B Charcoal Deep Clean Stain Removal Toothbrush Medium,9900,0,1,9900,232,FALSE,4,0,1,928,42.67,High,0.232,9900,39600
Personal Care,Mamaearth 100% Natural Berry Blast Kids Toothpaste,14900,10,4,13400,50,FALSE,50,1500,1,2500,268,High,0.05,13400,670000
Personal Care,HImalaya Gentle Baby Wipes,20000,10,3,18000,72,FALSE,72,2000,1,5184,250,High,0.072,18000,1296000
Personal Care,Stayfree Dry Max All Night XL Dry Cover Sanitary Pads,34000,12,6,29800,28,FALSE,28,4200,1,784,1064.29,High,0.028,29800,834400
Personal Care,"L'Oreal Paris Excellence Creme Hair Color, 1 Black",62000,0,1,62000,172,FALSE,172,0,1,29584,360.47,High,0.172,62000,10664000
Personal Care,Fem Fairness Naturals Saffron Skin Bleach,8500,15,4,7200,64,FALSE,64,1300,1,4096,112.5,High,0.064,7200,460800
Personal Care,Engage Woman Blush Body Deo Spray,19500,10,5,17400,150,FALSE,150,2100,1,22500,116,High,0.15,17400,2610000
Personal Care,Dove Pink Rosa Beauty Bathinhg Bar,6000,0,6,6000,100,FALSE,100,0,1,10000,60,High,0.1,6000,600000
Personal Care,Sebamed Cleansing Bar,9900,10,4,8900,100,FALSE,100,1000,1,10000,89,High,0.1,8900,890000
Personal Care,Pampers Premium Care Pants - Large,109900,18,2,89900,44,FALSE,44,20000,1,1936,2043.18,High,0.044,89900,3955600
Personal Care,Nivea Women Deodorant Fresh Natural Long Lasting Freshness & 48h Protection,19900,20,2,15900,150,FALSE,150,4000,1,22500,106,High,0.15,15900,2385000
Personal Care,"L'Oreal Paris Excellence Creme Hair Color, 3 Dark Brown/Natural Darkest Brown",62000,0,6,62000,172,FALSE,172,0,1,29584,360.47,High,0.172,62000,10664000
Personal Care,Patanjali Kesh Kanti Natural Hair Cleanser,7500,9,4,6800,200,FALSE,200,700,1,40000,34,High,0.2,6800,1360000
Personal Care,Godrej No.1 Bathing Soap  Lime & Aloe Vera,14900,0,6,14900,600,FALSE,600,0,1,360000,24.83,High,0.6,14900,8940000
Personal Care,Pantene Advanced Control Hair Fall Solution Shampoo,12000,6,5,11200,180,FALSE,180,800,1,32400,62.22,High,0.18,11200,2016000
Personal Care,Veet Full Body Waxing Kit For Dry Skin,23500,7,6,21800,1160,FALSE,20,1700,1,23200,18.79,High,1.16,21800,436000
Personal Care,Johnson's Baby Skincare Wipes,24500,9,6,22100,72,FALSE,72,2400,1,5184,306.94,High,0.072,22100,1591200
Personal Care,Gillette Lemon Lime Shaving Foam,19900,11,4,17700,196,FALSE,196,2200,1,38416,90.31,High,0.196,17700,3469200
Personal Care,Old Spice After Shave Lotion Musk,21500,6,3,20000,100,FALSE,100,1500,1,10000,200,High,0.1,20000,2000000
Personal Care,Whisper Ultra Soft Air Fresh Sanitary Pads (XL) with Wings,31500,0,4,31500,30,FALSE,30,0,1,900,1050,High,0.03,31500,945000
Personal Care,Himalaya Baby Powder,8000,8,4,7300,100,FALSE,100,700,1,10000,73,High,0.1,7300,730000
Personal Care,Fiama Men's Refreshing Pulse Shower Gel,22500,20,4,18000,250,FALSE,250,4500,1,62500,72,High,0.25,18000,4500000
Personal Care,Whisper Ultra Clean XL Plus Sanitary Pad,17500,0,5,17500,870,FALSE,15,0,1,13050,20.11,High,0.87,17500,262500
Personal Care,Johnson's Baby Powder,14300,0,6,14300,200,FALSE,200,0,1,40000,71.5,High,0.2,14300,2860000
Personal Care,Dove Cream Beauty Bathing Bar,23500,9,6,21200,125,FALSE,125,2300,1,15625,169.6,High,0.125,21200,2650000
Personal Care,Patanjali Kesh Kanti Shikakai Hair Cleanser,9500,0,4,9500,200,FALSE,200,0,1,40000,47.5,High,0.2,9500,1900000
Personal Care,L'Oreal Paris Color Protect Conditioner,19900,0,3,19900,192,FALSE,192,0,1,36864,103.65,High,0.192,19900,3820800
Personal Care,Nivea Men Active Clean with Active Charcoal Shower Gel for Body Face & Hair,19900,4,5,19100,250,FALSE,250,800,1,62500,76.4,High,0.25,19100,4775000
Personal Care,L'Oreal 6 Oil Nourish Conditioner,13500,0,1,13500,192,FALSE,192,0,1,36864,70.31,High,0.192,13500,2592000
Personal Care,Godrej Easy Natural Black Hair Colour,2500,0,5,2500,20,FALSE,20,0,1,400,125,Medium,0.02,2500,50000
Personal Care,Dabur Gulabari Rose Water Daily Glow,8000,6,2,7500,250,FALSE,250,500,1,62500,30,High,0.25,7500,1875000
Personal Care,Himalaya Purifying Neem Face Wash,17000,10,6,15300,150,FALSE,150,1700,1,22500,102,High,0.15,15300,2295000
Personal Care,Fem Fairness Naturals Gold Skin Bleach,6500,9,3,5900,24,FALSE,24,600,1,576,245.83,High,0.024,5900,141600
Personal Care,Whisper Choice Ultra XL Sanitary Pad,13300,2,5,13000,1160,FALSE,20,300,0.9,23200,11.21,High,1.16,13000,260000
Personal Care,Dove Dandruff Care Shampoo,15800,6,5,14700,180,FALSE,180,1100,1,32400,81.67,High,0.18,14700,2646000
Personal Care,Head & Shoulders Anti Dandruff Anti Hairfall Shampoo,28500,0,5,28500,340,FALSE,240,0,1,81600,83.82,High,0.34,28500,6840000
Personal Care,L'Oreal Casting Creme Ebony Black Hair Color,55000,0,6,55000,159,FALSE,87,0,1,13833,345.91,High,0.159,55000,4785000
Personal Care,Mamaearth Onion Hair Oil,39900,10,6,35900,150,FALSE,150,4000,1,22500,239.33,High,0.15,35900,5385000
Personal Care,L'Oreal Paris Casting Creme Gloss Hair Color (Dark Brown 400),55000,0,4,55000,159,FALSE,159,0,1,25281,345.91,High,0.159,55000,8745000
Personal Care,Palmolive Naturals Sea Minerals Liquid Hand Wash,9900,10,6,8900,250,FALSE,250,1000,1,62500,35.6,High,0.25,8900,2225000
Personal Care,Oral-B Extra Soft Bristles Sensitive ,9800,0,4,9800,232,FALSE,4,0,1,928,42.24,High,0.232,9800,39200
Personal Care,Engage M3 Perfume Spray for Men,20000,10,3,18000,120,FALSE,120,2000,1,14400,150,High,0.12,18000,2160000
Personal Care,Mamaearth Deeply Nourishing wash for Babies,19900,0,4,19900,200,FALSE,200,0,1,40000,99.5,High,0.2,19900,3980000
Personal Care,Dettol Original Soap (B4G1),26000,5,6,24700,625,FALSE,625,1300,1,390625,39.52,High,0.625,24700,15437500
Personal Care,Woodward's Gripe Water,7500,0,6,7500,200,FALSE,200,0,1,40000,37.5,High,0.2,7500,1500000
Personal Care,"MamyPoko Pants Extra Absorb Diapers, New Born",29900,6,5,27900,28,FALSE,28,2000,1,784,996.43,High,0.028,27900,781200
Personal Care,Johnson's Baby Soap,7000,0,6,7000,100,FALSE,100,0,1,10000,70,High,0.1,7000,700000
Personal Care,Engage M4 Perfume Spray For Men,20000,10,6,18000,120,FALSE,120,2000,1,14400,150,High,0.12,18000,2160000
Personal Care,Fem Fairness Naturals Hair Removal Cream Fair & Soft - Gold,6500,10,4,5800,40,FALSE,40,700,1,1600,145,High,0.04,5800,232000
Personal Care,Dove Hair Fall Rescue Conditioner,19000,0,4,19000,175,FALSE,175,0,1,30625,108.57,High,0.175,19000,3325000
Personal Care,Himalaya Anti Hair Fall Shampoo,13000,12,2,11400,200,FALSE,200,1600,1,40000,57,High,0.2,11400,2280000
Personal Care,Fiama Peach & Avocado Gel Bar,17600,10,3,15800,375,FALSE,375,1800,1,140625,42.13,High,0.375,15800,5925000
Personal Care,Pears Pure & Gentle Value Pack Of 4 Bathing Soap ,12500,0,6,12500,75,FALSE,75,0,1,5625,166.67,High,0.075,12500,937500
Personal Care,Fiama Fresh Hand Wash,15000,6,3,14000,400,FALSE,400,1000,1,160000,35,High,0.4,14000,5600000
Personal Care,Palmolive Black Orchid And Milk Liquid Hand Wash,9900,10,6,8900,250,FALSE,250,1000,1,62500,35.6,High,0.25,8900,2225000
Personal Care,Oral-B Criss Cross Medium Toothbrush (Buy 2 Get 2 Free),16000,0,5,16000,232,FALSE,4,0,1,928,68.97,High,0.232,16000,64000
Personal Care,Gillette Mach 3 Turbo Razor,34900,6,5,32500,58,FALSE,1,2400,1,58,560.34,High,0.058,32500,32500
Personal Care,Himalaya Baby Lotion,16500,12,3,14500,200,FALSE,200,2000,1,40000,72.5,High,0.2,14500,2900000
Personal Care,Head & Shoulders 2-in-1 Cool Menthol Anti Dandruff Shampoo + Conditioner,37500,0,1,37500,340,FALSE,180,0,1,61200,110.29,High,0.34,37500,6750000
Personal Care,Sunsilk Lusciously Thick & Long Shampoo,24900,6,6,23400,340,FALSE,340,1500,1,115600,68.82,High,0.34,23400,7956000
Personal Care,Fiama Di Wills Men's Refreshing Pulse Shower Gel,22500,4,3,21400,250,FALSE,250,1100,1,62500,85.6,High,0.25,21400,5350000
Personal Care,Sebamed Anti - Dandruff Shampoo,60000,10,2,54000,200,FALSE,200,6000,1,40000,270,High,0.2,54000,10800000
Personal Care,Listerine Cool Mint Mouthwash - Mild Taste,15000,10,6,13500,250,FALSE,250,1500,1,62500,54,High,0.25,13500,3375000
Personal Care,"L'Oreal Paris Excellence Creme Hair Color, 4.25 Aishwarya's Brown",62000,0,6,62000,172,FALSE,172,0,1,29584,360.47,High,0.172,62000,10664000
Personal Care,Himalaya Gentle Baby Bath,16500,9,6,15000,200,FALSE,200,1500,1,40000,75,High,0.2,15000,3000000
Personal Care,"L'Oreal Paris Casting Creme Gloss Hair Color, Medium Brown 500",55000,0,4,55000,160,FALSE,159,0,1,25440,343.75,High,0.16,55000,8745000
Personal Care,L'Oreal Paris Color Protect Shampoo,28200,0,3,28200,360,FALSE,360,0,1,129600,78.33,High,0.36,28200,10152000
Personal Care,Fiama Di Wills Lemongrass & Jojoba Gel Bar,17600,10,6,15800,375,FALSE,375,1800,1,140625,42.13,High,0.375,15800,5925000
Personal Care,Colgate Plax Peppermint Mouthwash,15000,20,5,12000,250,FALSE,250,3000,1,62500,48,High,0.25,12000,3000000
Personal Care,Dove Daily Shine Conditioner,9000,10,1,8100,80,FALSE,80,900,1,6400,101.25,High,0.08,8100,648000
Personal Care,Patanjali Kesh Kanti Anti Dandruff Hair Cleanser,11000,0,6,11000,200,FALSE,200,0,1,40000,55,High,0.2,11000,2200000
Personal Care,Old Spice Original After Shave Lotion,25000,0,1,25000,150,FALSE,150,0,1,22500,166.67,High,0.15,25000,3750000
Personal Care,Dove Hair Fall Rescue Shampoo,13700,10,4,12300,180,FALSE,180,1400,1,32400,68.33,High,0.18,12300,2214000
Personal Care,Dettol Clinical Strength Hand Sanitizer Liquid,25000,10,6,22500,500,FALSE,500,2500,1,250000,45,High,0.5,22500,11250000
Personal Care,Nivea Soft Light Moisturizer for Face Hand & Body Non-Sticky Cream with Vitamin E & Jojoba Oil,39900,20,3,31900,300,FALSE,300,8000,1,90000,106.33,High,0.3,31900,9570000
Personal Care,Comfy Baby Pants XL 12-17 kg,42900,15,1,36400,24,FALSE,24,6500,1,576,1516.67,High,0.024,36400,873600
Personal Care,Dettol Liquid Handwash With Free Liquid,9900,0,6,9900,200,FALSE,200,0,1,40000,49.5,High,0.2,9900,1980000
Personal Care,Nivea Body Milk Lotion for Very Dry Skin,39900,20,6,31900,400,FALSE,400,8000,1,160000,79.75,High,0.4,31900,12760000
Personal Care,Lakme Sun Expert,22500,0,6,22500,60,FALSE,60,0,1,3600,375,High,0.06,22500,1350000
Personal Care,Head & shoulders Anti Dandruff Shampoo Cool Menthol,17000,0,6,17000,180,FALSE,180,0,1,32400,94.44,High,0.18,17000,3060000
Personal Care,Godrej Nupur Henna,7500,0,5,7500,150,FALSE,120,0,1,18000,50,High,0.15,7500,900000
Personal Care,Johnson's Baby Lotion,10000,0,4,10000,100,FALSE,100,0,1,10000,100,High,0.1,10000,1000000
Personal Care,Himalaya Anti Dandruff Shampoo,14000,10,1,12600,200,FALSE,200,1400,1,40000,63,High,0.2,12600,2520000
Personal Care,Maybelline New York Colossal Kajal Super Black,30000,8,3,27500,0,FALSE,0,2500,1,0,#DIV/0!,High,0,27500,0
Personal Care,Stayfree Dry-Max All Night Ultra-Dry Sanitary Pad,9000,10,6,8100,406,FALSE,7,900,1,2842,19.95,High,0.406,8100,56700
Personal Care,Dove Daily Shine Shampoo,64500,5,3,61200,650,FALSE,650,3300,1,422500,94.15,High,0.65,61200,39780000
Personal Care,Godrej Easy 5 Minute Natural Brown 4 Hair Colour,2900,0,5,2900,20,FALSE,20,0,1,400,145,Medium,0.02,2900,58000
Personal Care,Colgate Sensitive Plus Enamel Toothpaste Tube,14000,0,6,14000,160,FALSE,160,0,1,25600,87.5,High,0.16,14000,2240000
Personal Care,Colgate Max Fresh Peppermint Toothpaste ,18200,15,6,15400,300,FALSE,300,2800,1,90000,51.33,High,0.3,15400,4620000
Personal Care,Pond's Light Moisturiser,30900,10,6,27800,250,FALSE,250,3100,1,62500,111.2,High,0.25,27800,6950000
Personal Care,Engage Mate For Man Deo Spray,19500,10,5,17400,150,FALSE,150,2100,1,22500,116,High,0.15,17400,2610000
Personal Care,Pantene Advanced Hair Fall Solution Shampoo - Total Damage Care,12000,0,5,12000,180,FALSE,180,0,1,32400,66.67,High,0.18,12000,2160000
Personal Care,Whisper Choice Regular Wing Sanitary Pad,3000,0,2,3000,406,FALSE,7,0,0.9,2842,7.39,Medium,0.406,3000,21000
Personal Care,Colgate Slim Soft Charcoal Toothbrush,15000,18,4,12300,232,FALSE,4,2700,1,928,53.02,High,0.232,12300,49200
Personal Care,Fiama Scents Juniper & Geranium Body Wash,19900,6,5,18600,250,FALSE,250,1300,1,62500,74.4,High,0.25,18600,4650000
Personal Care,Mamaearth Ubtan Body Lotion,39900,15,4,33900,400,FALSE,400,6000,1,160000,84.75,High,0.4,33900,13560000
Personal Care,Godrej Aer Power Pocket - Long Lasting Bathroom Fragrance Floral Delight,5500,0,6,5500,10,FALSE,10,0,1,100,550,High,0.01,5500,55000
Personal Care,Himalaya Anti-Hair Fall Shampoo,23000,18,1,18800,400,FALSE,400,4200,1,160000,47,High,0.4,18800,7520000
Personal Care,Nivea Soft Light Moisturizer for Face Hand & Body Non-Sticky Cream with Vitamin E & Jojoba Oil,31000,15,6,26300,200,FALSE,200,4700,1,40000,131.5,High,0.2,26300,5260000
Personal Care,Engage M2 Perfume Spray For Men,20000,10,6,18000,120,FALSE,120,2000,1,14400,150,High,0.12,18000,2160000
Personal Care,Mamaearth Ubtan Face Scrub Turmeric & Walnut,34900,10,1,31400,100,FALSE,100,3500,1,10000,314,High,0.1,31400,3140000
Personal Care,Himalaya Purifying Neem Face Wash Tube,27000,15,6,22900,300,FALSE,300,4100,1,90000,76.33,High,0.3,22900,6870000
Personal Care,Johnson's Baby Top To Toe Bath Body Wash,16500,0,4,16500,210,FALSE,210,0,1,44100,78.57,High,0.21,16500,3465000
Personal Care,Gillette Mach 3 Start,24900,0,6,24900,116,FALSE,2,0,1,232,214.66,High,0.116,24900,49800
Personal Care,Scalpe Pro Anti dandruff Shampoo 100ml,18500,0,2,18500,100,FALSE,100,0,1,10000,185,High,0.1,18500,1850000
Personal Care,Johnson's Baby Cream,15000,0,6,15000,100,FALSE,100,0,1,10000,150,High,0.1,15000,1500000
Personal Care,Johnson's Baby Soap,10500,0,6,10500,150,FALSE,150,0,1,22500,70,High,0.15,10500,1575000
Personal Care,Himalaya Gentle Baby Shampoo,32000,17,6,26500,400,FALSE,400,5500,1,160000,66.25,High,0.4,26500,10600000
Personal Care,L'Oreal Paris Shine Masque Royal Jelly Hair Colour,55000,0,3,55000,88,FALSE,87,0,1,7656,625,High,0.088,55000,4785000
Personal Care,Engage Rush Deodorant For Men,19000,11,6,16900,150,FALSE,150,2100,1,22500,112.67,High,0.15,16900,2535000
Personal Care,Clean & Clear Foaming Face Wash,14000,10,4,12600,100,FALSE,100,1400,1,10000,126,High,0.1,12600,1260000
Personal Care,Dettol Lather Shaving Cream,7500,5,6,7100,78,FALSE,78,400,1,6084,91.03,High,0.078,7100,553800
Personal Care,Gillette Classic Regular Pre Shave Foam,19900,0,4,19900,196,FALSE,196,0,1,38416,101.53,High,0.196,19900,3900400
Personal Care,Dove Daily Shine Conditioner,19000,0,6,19000,175,FALSE,180,0,1,31500,108.57,High,0.175,19000,3420000
Personal Care,Johnson's Baby Shampoo,18000,0,6,18000,200,FALSE,200,0,1,40000,90,High,0.2,18000,3600000
Personal Care,Park Avenue Beer Shampoo ,15500,9,4,14000,180,FALSE,180,1500,1,32400,77.78,High,0.18,14000,2520000
Personal Care,Pantene Advanced Hair Fall Solution Silky Smooth Care Shampoo,12000,6,6,11200,180,FALSE,180,800,1,32400,62.22,High,0.18,11200,2016000
Personal Care,Fem Fairness Naturals Hair Removal Cream Fair & Soft - Rose,6500,10,6,5800,40,FALSE,40,700,1,1600,145,High,0.04,5800,232000
Personal Care,Sunsilk Stunning Black Shine Shampoo,55500,6,6,52100,650,FALSE,650,3400,1,422500,80.15,High,0.65,52100,33865000
Personal Care,Dabur Meswak Toothpaste,10000,0,1,10000,200,FALSE,200,0,1,40000,50,High,0.2,10000,2000000
Personal Care,Patanjali Kesh Kanti Reetha Hair Cleanser,8500,0,5,8500,200,FALSE,200,0,1,40000,42.5,High,0.2,8500,1700000
Personal Care,Nivea Lip Balm Soft Rose for 24h Moisture with Natural Oils Delicate Rose Shine,18500,8,6,16900,5,FALSE,4,1600,1,20,3380,High,0.005,16900,67600
Personal Care,Santoor Total Skin Care Soap With Sandal & Turmeric,18000,0,6,18000,600,FALSE,600,0,1,360000,30,High,0.6,18000,10800000
Personal Care,"L'Oreal Paris Excellence Creme Hair Color, 4 Natural Brown/Natural Dark Brown",62000,0,1,62000,172,FALSE,172,0,1,29584,360.47,High,0.172,62000,10664000
Personal Care,Gillette Pre Shave Foam - Classic Regular Skin,22500,0,6,22500,418,FALSE,418,0,1,174724,53.83,High,0.418,22500,9405000
Personal Care,Fiama Di Wills Shower Gel Patchouli & Macadamia,19900,10,6,17900,250,FALSE,250,2000,1,62500,71.6,High,0.25,17900,4475000
Personal Care,Listerine Fresh Burst Mouthwash,14000,10,4,12600,250,FALSE,250,1400,1,62500,50.4,High,0.25,12600,3150000
Personal Care,Nivea Cocoa Nourish Body Lotion With Coconut Oil & Cocoa Butter For Very Dry Skin ,29900,17,5,24700,200,FALSE,200,5200,1,40000,123.5,High,0.2,24700,4940000
Personal Care,Pantene Hair Fall Control Shampoo,24000,7,2,22100,340,FALSE,340,1900,1,115600,65,High,0.34,22100,7514000
Personal Care,Fogg Master - Royal Intense,25000,0,5,25000,120,FALSE,120,0,1,14400,208.33,High,0.12,25000,3000000
Personal Care,TRESemme Smooth And Shine Conditioner,22000,0,5,22000,190,FALSE,190,0,1,36100,115.79,High,0.19,22000,4180000
Personal Care,Whisper Ultra Clean XL Plus Sanitary Pad,15500,0,6,15500,870,FALSE,15,0,0.9,13050,17.82,High,0.87,15500,232500
Personal Care,"Colgate Kids Toothpaste - 6+ Years, Strawberry Flavour",9300,5,6,8800,80,FALSE,80,500,1,6400,110,High,0.08,8800,704000
Personal Care,Nivea Soft Moisturizing Cream,31000,12,1,27200,200,FALSE,200,3800,1,40000,136,High,0.2,27200,5440000
Personal Care,Patanjali Kesh Kanti Aloe Vera Hair Cleanser,8500,0,5,8500,200,FALSE,200,0,1,40000,42.5,High,0.2,8500,1700000
Personal Care,Neutrogena Deep Clean Foaming Cleanser,13000,11,2,11500,50,FALSE,50,1500,1,2500,230,High,0.05,11500,575000
Personal Care,Clean & Clear Morning Energy Berry Face Wash,15500,6,6,14500,100,FALSE,100,1000,1,10000,145,High,0.1,14500,1450000
Personal Care,Pampers Premium Care New Baby Pants,32000,0,4,32000,24,FALSE,24,0,1,576,1333.33,High,0.024,32000,768000
Personal Care,Vaseline Intensive Care Aloe Fresh,22500,9,6,20300,200,FALSE,200,2200,1,40000,101.5,High,0.2,20300,4060000
Personal Care,L'Oreal Paris Dream Lengths Shampoo,14900,0,6,14900,192,FALSE,192,0,1,36864,77.6,High,0.192,14900,2860800
Personal Care,Johnson's Baby Oil,11500,0,4,11500,100,FALSE,100,0,1,10000,115,High,0.1,11500,1150000
Personal Care,Engage Man Rush Deodorant,19500,9,6,17600,150,FALSE,150,1900,1,22500,117.33,High,0.15,17600,2640000
Personal Care,Pantene Advanced Hair Fall Solution Shampoo - Total Damage Care,26400,0,6,26400,340,FALSE,340,0,1,115600,77.65,High,0.34,26400,8976000
Personal Care,Whisper Daily Liners Clean and Fresh,10500,0,4,10500,1160,FALSE,20,0,0.9,23200,9.05,High,1.16,10500,210000
Personal Care,Himalaya Men Pimple Clear Neem Face Wash,18000,9,2,16300,100,FALSE,100,1700,1,10000,163,High,0.1,16300,1630000
Personal Care,Pantene Adv Hairfall Solution Conditioner Silky Smooth,19000,0,5,19000,200,FALSE,200,0,1,40000,95,High,0.2,19000,3800000
Personal Care,Himalaya Prickly Heat Baby Powder,9000,10,6,8100,100,FALSE,100,900,1,10000,81,High,0.1,8100,810000
Personal Care,Mamaearth Daily Moisturizing Lotion For Babies,19900,0,6,19900,200,FALSE,200,0,1,40000,99.5,High,0.2,19900,3980000
Personal Care,Stayfree Advanced XL Ultra Comfort Sanitary napkins with Wings,17500,0,3,17500,812,FALSE,14,0,1,11368,21.55,High,0.812,17500,245000
Personal Care,Pampers Premium Care Pants - Medium,109900,18,6,89900,54,FALSE,54,20000,1,2916,1664.81,High,0.054,89900,4854600
Personal Care,Fiama Men's Refreshing Pulse Shower Gel,19900,10,6,17900,250,FALSE,250,2000,1,62500,71.6,High,0.25,17900,4475000
Personal Care,Vaseline Original Skin Protecting Jelly,12500,10,6,11200,100,FALSE,100,1300,1,10000,112,High,0.1,11200,1120000
Personal Care,Clean & Clear Foaming Face Wash,18000,10,6,16200,150,FALSE,150,1800,1,22500,108,High,0.15,16200,2430000
Personal Care,Fiama Lemongrass and Jojoba Shower Gel,22500,20,6,18000,250,FALSE,250,4500,1,62500,72,High,0.25,18000,4500000
Personal Care,Oral-B Charcoal Cross Cross Extra Soft Toothbrush (Buy 2 Get 1 Free),18000,0,1,18000,174,FALSE,3,0,1,522,103.45,High,0.174,18000,54000
Personal Care,Listerine Fresh Burst Mouthwash,28500,7,6,26300,500,FALSE,500,2200,1,250000,52.6,High,0.5,26300,13150000
Personal Care,Veet Full Body Waxing Kit,23500,7,6,21800,1160,FALSE,20,1700,1,23200,18.79,High,1.16,21800,436000
Personal Care,Listerine Original Mouthwash,5500,9,6,5000,80,FALSE,80,500,1,6400,62.5,High,0.08,5000,400000
Personal Care,Santoor Almond Soft With Sandal & Almond Milk,18000,0,2,18000,625,FALSE,625,0,1,390625,28.8,High,0.625,18000,11250000
Personal Care,Nivea Body Shea Smooth with Shea Butter for Dry Skin,42500,20,5,34000,400,FALSE,9,8500,1,3600,85,High,0.4,34000,306000
Personal Care,Neutrogena Deep Clean Facial Cleanser,13000,0,4,13000,50,FALSE,50,0,1,2500,260,High,0.05,13000,650000
Personal Care,"L'Oreal Paris Excellence Creme Hair Color, 3.16 Burgundy",55000,0,3,55000,159,FALSE,172,0,1,27348,345.91,High,0.159,55000,9460000
Personal Care,Johnson's Baby Powder,23500,0,6,23500,400,FALSE,400,0,1,160000,58.75,High,0.4,23500,9400000
Personal Care,Bombay Shaving Company Charcoal Face Wash,24900,0,4,24900,100,FALSE,100,0,1,10000,249,High,0.1,24900,2490000
Personal Care,Colgate Kids 2+ Years Extra Soft Toothbrush,2000,0,3,2000,58,FALSE,1,0,1,58,34.48,Medium,0.058,2000,2000
Personal Care,Veet Hair Removal Cream (Normal Skin),13500,5,6,12800,50,FALSE,50,700,1,2500,256,High,0.05,12800,640000
Personal Care,Dove Daily Shine Shampoo,24000,0,4,24000,340,FALSE,340,0,1,115600,70.59,High,0.34,24000,8160000
Personal Care,L'Oreal Anti Hair Fall Conditioner,19900,0,6,19900,192,FALSE,192,0,1,36864,103.65,High,0.192,19900,3820800
Personal Care,Nivea Body Lotion Aloe Hydration For Normal Skin ,27500,10,6,24700,200,FALSE,200,2800,1,40000,123.5,High,0.2,24700,4940000
Personal Care,Pampers Pants - Large,154900,45,3,84900,82,FALSE,82,70000,1,6724,1035.37,High,0.082,84900,6961800
Personal Care,"Engage Urge Deodorant For Men, Citrus And Woody, Skin Friendly",19500,10,6,17400,150,FALSE,150,2100,1,22500,116,High,0.15,17400,2610000
Personal Care,Head & Shoulders 2 In 1 Anti Dandruff Smooth & Silky Shampoo+Conditioner,37500,10,6,33400,340,FALSE,340,4100,1,115600,98.24,High,0.34,33400,11356000
Personal Care,Fem Fairness Natural Gold Skin Bleach,8500,7,4,7900,64,FALSE,64,600,1,4096,123.44,High,0.064,7900,505600
Personal Care,Engage Deo Frost,19500,9,6,17600,150,FALSE,150,1900,1,22500,117.33,High,0.15,17600,2640000
Personal Care,Stayfree Secure XL Size Sanitary Napkins,11500,0,5,11500,1160,FALSE,20,0,0.9,23200,9.91,High,1.16,11500,230000
Personal Care,Pampers Pants - Medium,69900,21,1,54900,50,FALSE,50,15000,1,2500,1098,High,0.05,54900,2745000
Personal Care,Pampers Active Baby Diapers New Born Extra Small ,109900,22,3,84900,72,FALSE,72,25000,1,5184,1179.17,High,0.072,84900,6112800
Personal Care,"Nivea Creme, All Season Multi-Purpose Cream",17500,9,6,15800,100,FALSE,100,1700,1,10000,158,High,0.1,15800,1580000
Personal Care,Woodwards Gripe Water ,5000,0,4,5000,130,FALSE,130,0,1,16900,38.46,High,0.13,5000,650000
Personal Care,Clean & Clear Morning Energy Aqua Splash Face Wash,14500,9,5,13100,100,FALSE,100,1400,1,10000,131,High,0.1,13100,1310000
Personal Care,Sunsilk Lusciously Thick & Long Shampoo,55500,6,6,52100,650,FALSE,650,3400,1,422500,80.15,High,0.65,52100,33865000
Personal Care,Mamaearth Skin Correct Face Serum,59900,15,1,50900,30,FALSE,30,9000,1,900,1696.67,High,0.03,50900,1527000
Personal Care,Chik Hairfall Prevent Egg Shampoo,17800,0,6,17800,340,FALSE,340,0,1,115600,52.35,High,0.34,17800,6052000
Personal Care,Pantene Silky Smooth Care Shampoo,22500,6,3,21000,340,FALSE,340,1500,1,115600,61.76,High,0.34,21000,7140000
Personal Care,"Garnier Skin Naturals, Micellar Cleansing Water",19900,5,4,18900,125,FALSE,125,1000,1,15625,151.2,High,0.125,18900,2362500
Personal Care,Set Wet Swag Avatar Deodorant & Body Spray Perfume For Men,19900,0,1,19900,150,FALSE,150,0,1,22500,132.67,High,0.15,19900,2985000
Personal Care,Pampers All Round Protection Pants - Medium,69900,17,6,57500,50,FALSE,50,12400,1,2500,1150,High,0.05,57500,2875000
Personal Care,Set Wet Deodrant Charm Avatar,19900,0,1,19900,150,FALSE,150,0,1,22500,132.67,High,0.15,19900,2985000
Personal Care,Nupur Heena Mehandi,19900,0,6,19900,500,FALSE,500,0,1,250000,39.8,High,0.5,19900,9950000
Personal Care,Head & Shoulders 2-in-1 Active Protect Shampoo,37500,9,6,33800,340,FALSE,340,3700,1,115600,99.41,High,0.34,33800,11492000
Personal Care,Gillette Mach 3 Turbo Cartridges,64900,10,6,57800,232,FALSE,4,7100,1,928,249.14,High,0.232,57800,231200
Personal Care,TRESemme Smooth And Shine Conditioner,21000,13,1,18200,190,FALSE,190,2800,1,36100,95.79,High,0.19,18200,3458000
Personal Care,Bombay Shaving Company Sensitive Cartridges,37500,0,2,37500,116,FALSE,2,0,1,232,323.28,High,0.116,37500,75000
Personal Care,Himalaya Baby Lotion,30000,12,1,26400,400,FALSE,400,3600,1,160000,66,High,0.4,26400,10560000
Personal Care,Old Spice Lime Lather Shaving Cream,7500,0,6,7500,70,FALSE,70,0,1,4900,107.14,High,0.07,7500,525000
Personal Care,Colgate Sensitive Plus Anticavity Toothpaste ,14000,10,6,12600,70,FALSE,70,1400,1,4900,180,High,0.07,12600,882000
Personal Care,Colgate Toothpaste For Kids Motu Oatlu,9300,0,6,9300,80,FALSE,80,0,1,6400,116.25,High,0.08,9300,744000
Personal Care,Pantene Total Damage Care Shampoo,12000,0,6,12000,180,FALSE,180,0,1,32400,66.67,High,0.18,12000,2160000
Personal Care,Himalaya Moisturising Aloe Vera Facial Wipes,10000,10,6,9000,25,FALSE,25,1000,1,625,360,High,0.025,9000,225000
Personal Care,Savlon Moisture Shield Hand Wash,6900,0,5,6900,200,FALSE,200,0,1,40000,34.5,High,0.2,6900,1380000
Personal Care,Pampers Active Baby Diapers New Born Extra Small,36000,10,6,32400,24,FALSE,24,3600,1,576,1350,High,0.024,32400,777600
Personal Care,Himalaya Anti Dandruff Shampoo,26000,18,1,21300,400,FALSE,400,4700,1,160000,53.25,High,0.4,21300,8520000
Personal Care,Himalaya Anti Hair Fall Shampoo,49000,25,4,36700,700,FALSE,700,12300,1,490000,52.43,High,0.7,36700,25690000
Personal Care,Johnson's Baby Oil,20000,0,6,20000,200,FALSE,200,0,1,40000,100,High,0.2,20000,4000000
Personal Care,Vaseline Intensive Care Deep Moisture Body Lotion,32500,0,4,32500,400,FALSE,400,0,1,160000,81.25,High,0.4,32500,13000000
Personal Care,L'Oreal Paris Dream Lengths Conditioner,19900,0,1,19900,193,FALSE,193,0,1,37249,103.11,High,0.193,19900,3840700
Personal Care,Nivea Soft Light Moisturizing Cream,18500,15,6,15700,100,FALSE,100,2800,1,10000,157,High,0.1,15700,1570000
Personal Care,Whisper Ultra Soft XL+ Sanitary Pads,55500,0,1,55500,60,FALSE,60,0,1,3600,925,High,0.06,55500,3330000
Personal Care,Palmolive Feel The Massage Shower Gel,24900,20,6,19900,250,FALSE,250,5000,1,62500,79.6,High,0.25,19900,4975000
Personal Care,L'Oreal Paris Dream Lengths Conditioner,20900,0,3,20900,193,FALSE,193,0,1,37249,108.29,High,0.193,20900,4033700
Personal Care,Head & Shoulders Anti-Dandruff Smooth & Silky Shampoo,28500,6,6,26600,340,FALSE,340,1900,1,115600,78.24,High,0.34,26600,9044000
Personal Care,Mamaearth Moisturizing Baby Bath Soap,24900,0,4,24900,150,FALSE,150,0,1,22500,166,High,0.15,24900,3735000
Personal Care,Listerine Original Mouthwash,15000,10,6,13500,250,FALSE,250,1500,1,62500,54,High,0.25,13500,3375000
Personal Care,Himalaya Gentle Baby Shampoo,17000,14,6,14600,200,FALSE,200,2400,1,40000,73,High,0.2,14600,2920000
Personal Care,Dove Dryness Care Shampoo,26800,5,1,25200,340,FALSE,340,1600,1,115600,74.12,High,0.34,25200,8568000
Personal Care,Dove Hair Fall Rescue Shampoo,28000,15,6,23600,340,FALSE,340,4400,1,115600,69.41,High,0.34,23600,8024000
Personal Care,Head & Shoulders Anti Dandruff Shampoo Cool Menthol,29500,9,6,26600,340,FALSE,340,2900,1,115600,78.24,High,0.34,26600,9044000
Personal Care,Bombay Shaving Company Defender Razor,34500,0,6,34500,58,FALSE,1,0,1,58,594.83,High,0.058,34500,34500
Personal Care,"Head & Shoulders Shampoo + Conditioner - 2-In-1, Cool Menthol",36500,0,1,36500,340,FALSE,340,0,1,115600,107.35,High,0.34,36500,12410000
Personal Care,Himalaya Baby Nourishing Massage Oil,20000,20,2,16000,200,FALSE,250,4000,1,50000,80,High,0.2,16000,4000000
Personal Care,Himalaya Baby Powder,23500,20,6,18800,400,FALSE,400,4700,1,160000,47,High,0.4,18800,7520000
Personal Care,Fogg Paradise Fragrant Body Spray For Women ,25000,0,6,25000,150,FALSE,150,0,1,22500,166.67,High,0.15,25000,3750000
Personal Care,Revive Revive Liquid,7100,0,6,7100,200,FALSE,200,0,1,40000,35.5,High,0.2,7100,1420000
Personal Care,Pantene Hairfall Control Conditioner,19000,6,6,17800,200,FALSE,200,1200,1,40000,89,High,0.2,17800,3560000
Personal Care,Mamaearth Vitamin C Face Toner,39900,0,1,39900,200,FALSE,200,0,1,40000,199.5,High,0.2,39900,7980000
Personal Care,Himalaya Diaper Rash Cream,8000,10,2,7200,20,FALSE,20,800,1,400,360,High,0.02,7200,144000
Personal Care,Fogg Royal Fragrance Spray,23000,0,4,23000,150,FALSE,120,0,1,18000,153.33,High,0.15,23000,2760000
Personal Care,Dove Pink Rosa Beauty Bathing Bar,24500,9,6,22100,100,FALSE,100,2400,1,10000,221,High,0.1,22100,2210000
Personal Care,Dove Dryness Care Conditioner Frizzy & Dry Hair,9000,6,4,8400,80,FALSE,80,600,1,6400,105,High,0.08,8400,672000
Personal Care,Dettol Original Liquid Handwash Refill,10900,3,0,10500,750,TRUE,750,400,0.9,562500,14,High,0.75,10500,7875000
Personal Care,Parachute 100% Pure Coconut Oil,12300,0,0,12300,300,TRUE,300,0,1,90000,41,High,0.3,12300,3690000
Personal Care,Stayfree Secure Cottony Soft Cover Sanitary Pad (Regular) with Wings,3000,3,0,2900,406,TRUE,7,100,0.9,2842,7.14,Medium,0.406,2900,20300
Personal Care,Dabur Gulabari Premium Rose Water,4800,2,0,4700,120,TRUE,120,100,1,14400,39.17,High,0.12,4700,564000
Personal Care,Parachute Advansed Gold Coconut Hair Oil,21500,9,0,19400,400,TRUE,400,2100,1,160000,48.5,High,0.4,19400,7760000
Personal Care,Closeup Everfresh+ Anti-Germ Gel Toothpaste Red Hot,9000,10,0,8100,150,TRUE,150,900,1,22500,54,High,0.15,8100,1215000
Personal Care,Godrej No.1 Bathing Soap  Lime & Aloe Vera,10000,16,0,8400,500,TRUE,100,1600,1,50000,16.8,High,0.5,8400,840000
Personal Care,Sensodyne Sensitive Fresh Gel Toothpaste,11500,7,0,10600,75,TRUE,75,900,1,5625,141.33,High,0.075,10600,795000
Personal Care,Whisper Bindazzz Nights XL + Sanitary Pad,9000,0,0,9000,406,TRUE,7,0,1,2842,22.17,High,0.406,9000,63000
Personal Care,Whisper Choice Sanitary Pad ,3200,9,0,2900,406,TRUE,7,300,0.9,2842,7.14,Medium,0.406,2900,20300
Personal Care,"Godrej No.1 Bathing Soap, Jasmine",8400,0,0,8400,400,TRUE,100,0,1,40000,21,High,0.4,8400,840000
Personal Care,Gillette Venus Close & Clean Razor ,24900,7,0,23000,58,TRUE,1,1900,1,58,396.55,High,0.058,23000,23000
Personal Care,Whisper Choice Regular Sanitary Pads,9000,3,0,8700,58,TRUE,20,300,1,1160,150,High,0.058,8700,174000
Personal Care,Stayfree Secure Dry Cover Extra Large Sanitary Pad,4200,2,0,4100,406,TRUE,7,100,0.9,2842,10.1,High,0.406,4100,28700
Personal Care,Oxylife Natural Radiance 5 Creme Bleach - With Active Oxygen,8200,9,0,7400,27,TRUE,27,800,1,729,274.07,High,0.027,7400,199800
Personal Care,Clean & Clear Morning Energy Lemon Face Wash,14500,9,0,13100,100,TRUE,100,1400,1,10000,131,High,0.1,13100,1310000
Personal Care,Bajaj Almond Drops Hair Oil,6700,10,0,6000,100,TRUE,100,700,1,10000,60,High,0.1,6000,600000
Personal Care,Bajaj Almond Drops Hair Oil Bottle,13000,7,0,12000,200,TRUE,200,1000,1,40000,60,High,0.2,12000,2400000
Personal Care,Whisper Bindazzz Night Sanitary Pads XL Plus,18500,0,0,18500,870,TRUE,15,0,1,13050,21.26,High,0.87,18500,277500
Personal Care,Godrej Cinthol Lime Refreshing Deo Soap,11600,0,0,11600,400,TRUE,400,0,1,160000,29,High,0.4,11600,4640000
Personal Care,"MamyPoko Pants Standard Diapers, Extra Large (12 - 17 kg)",39900,7,0,36900,26,TRUE,26,3000,1,676,1419.23,High,0.026,36900,959400
Paan Corner,Clove Sensitive Toothpaste with Anti-Sensitivity & Fluoride Formulation,16000,35,3,10400,80,FALSE,80,5600,1,6400,130,High,0.08,10400,832000
Paan Corner,Dettol Original Germ Protection Alcohol Based Hand Sanitizer,2500,0,6,2500,50,FALSE,50,0,1,2500,50,Medium,0.05,2500,125000
Paan Corner,Colgate Visible White Toothpaste,11500,10,6,10300,100,FALSE,100,1200,1,10000,103,High,0.1,10300,1030000
Paan Corner,Dettol SKincare Handwash Value Refill,10900,3,6,10500,750,FALSE,750,400,0.9,562500,14,High,0.75,10500,7875000
Paan Corner,Savlon Herbal Sensitive Liquid Handwash Refill Pouch,11500,4,6,11000,750,FALSE,500,500,0.9,375000,14.67,High,0.75,11000,5500000
Paan Corner,Colgate Total 12 Whole Mouth Protection Toothpaste,12000,10,6,10800,120,FALSE,120,1200,1,14400,90,High,0.12,10800,1296000
Paan Corner,Lux International Creamy White Soap Bar,3500,2,6,3400,75,FALSE,75,100,1,5625,45.33,Medium,0.075,3400,255000
Paan Corner,Colgate Herbal Toothpaste,11400,18,2,9300,200,FALSE,200,2100,1,40000,46.5,High,0.2,9300,1860000
Paan Corner,Nivea Men Deodorant Fresh Active 48h Long lasting Freshness,22500,24,6,16900,150,FALSE,150,5600,1,22500,112.67,High,0.15,16900,2535000
Paan Corner,Dabur Meswak Toothpaste,5800,5,6,5500,100,FALSE,100,300,1,10000,55,High,0.1,5500,550000
Paan Corner,Colgate Max Fresh Cooling Crystals Toothpaste,10100,5,2,9500,150,FALSE,150,600,1,22500,63.33,High,0.15,9500,1425000
Paan Corner,Indulekha Bhringa Hair Oil,43200,15,6,36700,100,FALSE,100,6500,1,10000,367,High,0.1,36700,3670000
Paan Corner,Colgate Sensitive Soft Bristles Toothbrush,5000,0,6,5000,58,FALSE,1,0,1,58,86.21,High,0.058,5000,5000
Paan Corner,Pears Pure & Gentle Glycerin Bath Soap,7500,0,6,7500,125,FALSE,125,0,1,15625,60,High,0.125,7500,937500
Paan Corner,Vaseline Skin Protecting Jelly,7900,13,6,6800,50,FALSE,50,1100,1,2500,136,High,0.05,6800,340000
Paan Corner,Dettol Original Germ Protection Bathing Soap Bar,16600,5,4,15700,375,FALSE,375,900,1,140625,41.87,High,0.375,15700,5887500
Paan Corner,Dettol Intense Cool Soap (B4G1),26000,5,6,24700,625,FALSE,625,1300,1,390625,39.52,High,0.625,24700,15437500
Paan Corner,Livon Anti-Frizz Serum,25000,10,3,22500,100,FALSE,100,2500,1,10000,225,High,0.1,22500,2250000
Paan Corner,Lifebuoy Germ Protection Care Soap Bar,3000,3,3,2900,100,FALSE,125,100,1,12500,29,Medium,0.1,2900,362500
Paan Corner,Lux International Creamy White Soap Bar,7000,10,6,6300,125,FALSE,125,700,1,15625,50.4,High,0.125,6300,787500
Paan Corner,Godrej Nupur  100% Pure Henna (Mehendi),1000,0,6,1000,18,FALSE,18,0,1,324,55.56,Low,0.018,1000,18000
Paan Corner,Glow & Lovely Advanced Multivitamin Face Cream,21300,10,6,19000,110,FALSE,110,2300,1,12100,172.73,High,0.11,19000,2090000
Paan Corner,Set Wet Style Vertical Hold Hair Gel,5000,10,4,4500,50,FALSE,50,500,1,2500,90,High,0.05,4500,225000
Paan Corner,"Godrej Expert Rich Crème, Natural Black",3000,0,6,3000,20,FALSE,20,0,1,400,150,Medium,0.02,3000,60000
Paan Corner,Nycil Germ Expert Cool Herbal Talc,13000,8,1,11900,150,FALSE,200,1100,1,30000,79.33,High,0.15,11900,2380000
Paan Corner,Godrej Expert Creme Hair Natural Brown Colour ,3000,0,6,3000,20,FALSE,20,0,1,400,150,Medium,0.02,3000,60000
Paan Corner,Veet Sensitive Skin Hair Removal Cream,13500,5,6,12800,50,FALSE,50,700,1,2500,256,High,0.05,12800,640000
Paan Corner,Closeup Everfresh+ Anti-Germ Gel Toothpaste Red Hot,5000,2,1,4900,80,FALSE,80,100,1,6400,61.25,High,0.08,4900,392000
Paan Corner,Pears Pure And Gentle Value Pack Of 3 Bathing Soap,19900,6,5,18600,375,FALSE,375,1300,1,140625,49.6,High,0.375,18600,6975000
Paan Corner,Gillette Presto Ready Shaver 5 Cartridges ,8800,6,6,8200,290,FALSE,5,600,1,1450,28.28,High,0.29,8200,41000
Paan Corner,Closeup Everfresh+ Anti-Germ Gel Toothpaste Red Hot,16000,10,4,14400,300,FALSE,300,1600,1,90000,48,High,0.3,14400,4320000
Paan Corner,"Godrej Expert Rich Crème, Dark Brown",3000,0,4,3000,20,FALSE,20,0,1,400,150,Medium,0.02,3000,60000
Paan Corner,Nivea Soft Light Moisturizer for Face Hand & Body Non-Sticky Cream with Vitamin E & Jojoba Oil ,18500,15,3,15700,100,FALSE,100,2800,1,10000,157,High,0.1,15700,1570000
Paan Corner,Fiama Gel Bar Celebration Pack Buy 4 Get 1 Free,29000,10,6,26100,625,FALSE,625,2900,1,390625,41.76,High,0.625,26100,16312500
Paan Corner,Gillette Sensitive Shaving Foam,22500,6,4,21000,418,FALSE,418,1500,1,174724,50.24,High,0.418,21000,8778000
Paan Corner,Dove Hair Fall Rescue Shampoo,15000,6,5,14100,180,FALSE,180,900,1,32400,78.33,High,0.18,14100,2538000
Paan Corner,Gillette Mach 3 Mens Razor Blades,49900,7,4,46000,232,FALSE,4,3900,1,928,198.28,High,0.232,46000,184000
Paan Corner,Palmolive Aroma Absolute Relax Shower Gel,19900,20,2,15900,250,FALSE,250,4000,1,62500,63.6,High,0.25,15900,3975000
Paan Corner,Godrej Protekt Germ Fighter Handwash,9900,0,6,9900,750,FALSE,750,0,0.9,562500,13.2,High,0.75,9900,7425000
Paan Corner,Dettol Hand Sanitizer,10000,5,6,9500,200,FALSE,200,500,1,40000,47.5,High,0.2,9500,1900000
Paan Corner,Dabur Amla Hair Oil,8800,0,2,8800,180,FALSE,180,0,1,32400,48.89,High,0.18,8800,1584000
Paan Corner,Dettol Original Liquid Handwash,8900,4,6,8500,200,FALSE,200,400,1,40000,42.5,High,0.2,8500,1700000
Paan Corner,L'Oreal Paris Total Repair 5 Conditioner,19900,0,6,19900,192,FALSE,180,0,1,34560,103.65,High,0.192,19900,3582000
Paan Corner,Patanjali Saundarya Aloe Vera Gel,9000,0,5,9000,150,FALSE,150,0,1,22500,60,High,0.15,9000,1350000
Paan Corner,Head & Shoulders 2 In 1 Anti Dandruff Shampoo Conditioner ,19500,10,4,17400,180,FALSE,180,2100,1,32400,96.67,High,0.18,17400,3132000
Paan Corner,Clean & Clear Pimple Clearing Face Wash,13000,10,2,11700,80,FALSE,80,1300,1,6400,146.25,High,0.08,11700,936000
Paan Corner,Himalaya Anti Dandruff Shampoo,14000,8,2,12800,200,FALSE,200,1200,1,40000,64,High,0.2,12800,2560000
Paan Corner,Stayfree Secure Dry Cover Regular Sanitary Pad With Wings,3000,3,6,2900,406,FALSE,7,100,0.9,2842,7.14,Medium,0.406,2900,20300
Paan Corner,Savlon Moisture Shield Hand Wash,9900,4,6,9500,750,FALSE,750,400,0.9,562500,12.67,High,0.75,9500,7125000
Paan Corner,Dove Intense Repair Conditioner,19000,14,6,16200,175,FALSE,80,2800,1,14000,92.57,High,0.175,16200,1296000
Paan Corner,Dabur Gulabari Rose Glow Face Cleanse,7500,5,4,7100,100,FALSE,100,400,1,10000,71,High,0.1,7100,710000
Paan Corner,Parachute Jasmine Hair Oil,8200,9,6,7400,190,FALSE,190,800,1,36100,38.95,High,0.19,7400,1406000
Paan Corner,Johnson's Baby Skincare Wipes,7900,6,6,7400,1160,FALSE,20,500,0.9,23200,6.38,High,1.16,7400,148000
Paan Corner,Dettol Skincare Liquid Hand Wash,7900,0,6,7900,200,FALSE,200,0,1,40000,39.5,High,0.2,7900,1580000
Paan Corner,Old Spice Original Lather Shaving Cream,7500,9,6,6800,70,FALSE,70,700,1,4900,97.14,High,0.07,6800,476000
Paan Corner,Veet Hair Removal Cream Dry Skin,13500,5,5,12800,50,FALSE,50,700,1,2500,256,High,0.05,12800,640000
Paan Corner,L'Oreal Paris Total Repair 5 Shampoo,26500,0,2,26500,396,FALSE,360,0,1,142560,66.92,High,0.396,26500,9540000
Paan Corner,Fiama Menthol & Magnolia Cooling Gel Bar Soap,16000,11,6,14100,375,FALSE,375,1900,1,140625,37.6,High,0.375,14100,5287500
Paan Corner,Nivea Lip Balm Original Care for 24h Moisture with Shea Butter & Natural Oils,14000,15,6,11900,5,FALSE,4,2100,1,20,2380,High,0.005,11900,47600
Paan Corner,Oral-B Charcoal Deep Clean Stain Removal Toothbrush Soft,9900,0,3,9900,232,FALSE,4,0,1,928,42.67,High,0.232,9900,39600
Paan Corner,Neutrogena Ultra Sheer Dry Touch SPF 50+ Sunblock Sunscreen Lotion,25000,10,3,22500,30,FALSE,30,2500,1,900,750,High,0.03,22500,675000
Paan Corner,Clinic Plus Strong & Long Health Shampoo,49900,10,3,44900,650,FALSE,650,5000,1,422500,69.08,High,0.65,44900,29185000
Paan Corner,Johnson's Baby No More Tears Baby Shampoo,9800,0,5,9800,100,FALSE,100,0,1,10000,98,High,0.1,9800,980000
Paan Corner,Colgate Zig Zag Toothbrush,12000,0,3,12000,348,FALSE,6,0,1,2088,34.48,High,0.348,12000,72000
Paan Corner,Savlon Moisture Shield Germ Protection Handwash Refill (Buy 1 Get 1 Free),18900,0,6,18900,1500,FALSE,1500,0,0.9,2250000,12.6,High,1.5,18900,28350000
Paan Corner,Colgate Sensitive Everyday Protection Anticavity Toothpaste,7500,0,6,7500,40,FALSE,40,0,1,1600,187.5,High,0.04,7500,300000
Paan Corner,Whisper Ultra Soft XL+ Sanitary Pads,33000,2,6,32300,30,FALSE,30,700,1,900,1076.67,High,0.03,32300,969000
Paan Corner,Garnier Colour Naturals Hair Colour - 1 Natural Black,8000,0,1,8000,60,FALSE,60,0,1,3600,133.33,High,0.06,8000,480000
Paan Corner,Axe Pulse Men's Deodorant,21000,0,6,21000,150,FALSE,150,0,1,22500,140,High,0.15,21000,3150000
Paan Corner,Colgate Zigzag Charcoal Soft Bristle Toothbrush - 4 Pcs,9900,0,6,9900,232,FALSE,4,0,1,928,42.67,High,0.232,9900,39600
Paan Corner,Whisper Ultra Clean Wings XL+  Pouch,44900,7,6,41500,44,FALSE,44,3400,1,1936,943.18,High,0.044,41500,1826000
Paan Corner,Whisper Choice Regular Sanitary Pads,9000,0,6,9000,1160,FALSE,20,0,0.9,23200,7.76,High,1.16,9000,180000
Paan Corner,Axe Dark Temptation Men's Deodorant,21000,7,5,19400,150,FALSE,150,1600,1,22500,129.33,High,0.15,19400,2910000
Paan Corner,Head & Shoulders Anti-Dandruff Smooth & Silky Shampoo,15000,0,4,15000,180,FALSE,180,0,1,32400,83.33,High,0.18,15000,2700000
Paan Corner,Clinic Plus Strength & Shine Shampoo With Egg Protein ,10500,0,2,10500,175,FALSE,175,0,1,30625,60,High,0.175,10500,1837500
Paan Corner,Engage M1 Perfume Spray for Men ,21000,7,6,19400,120,FALSE,120,1600,1,14400,161.67,High,0.12,19400,2328000
Paan Corner,Tresemme Keratin Smooth Conditioner,38000,0,3,38000,340,FALSE,340,0,1,115600,111.76,High,0.34,38000,12920000
Paan Corner,"Garnier Color Naturals Crème Hair Color, Shade 5 Light Brown",18000,0,1,18000,100,FALSE,100,0,1,10000,180,High,0.1,18000,1800000
Paan Corner,Origami Aloe Vera Wipes,7500,13,4,6500,25,FALSE,25,1000,1,625,260,High,0.025,6500,162500
Paan Corner,"Engage Drizzle Deodorant For Women, Floral And Lavender, Skin Friendly",19500,10,6,17400,150,FALSE,150,2100,1,22500,116,High,0.15,17400,2610000
Paan Corner,Gellette Presto Ready Shaver,2000,0,1,2000,58,FALSE,1,0,1,58,34.48,Medium,0.058,2000,2000
Paan Corner,Colgate Max Fresh Plax Mouthwash - Fresh Mint,15000,20,5,12000,250,FALSE,250,3000,1,62500,48,High,0.25,12000,3000000
Paan Corner,Colgate Zig Zag Charcoal Medium Toothbrush 4 Pcs,9900,0,6,9900,232,FALSE,4,0,1,928,42.67,High,0.232,9900,39600
Paan Corner,Godrej Protekt,9900,0,3,9900,750,FALSE,750,0,0.9,562500,13.2,High,0.75,9900,7425000
Paan Corner,Colgate Total Charcoal Anticavity Toothpaste,11000,10,3,9900,120,FALSE,120,1100,1,14400,82.5,High,0.12,9900,1188000
Paan Corner,Colgate Kids 0-2 Extra Soft Tooth Brush,3000,16,6,2500,58,FALSE,1,500,1,58,43.1,Medium,0.058,2500,2500
Paan Corner,Gillete Mach3 ,26000,10,6,23400,116,FALSE,2,2600,1,232,201.72,High,0.116,23400,46800
Paan Corner,Maybelline New York Colossal Kajal Black,14900,0,2,14900,0,FALSE,0,0,1,0,#DIV/0!,High,0,14900,0
Paan Corner,Godrej Cinthol Lime Talc,5500,0,3,5500,100,FALSE,100,0,1,10000,55,High,0.1,5500,550000
Paan Corner,Hamam Soap Bar Neem Tulsi and Aloe Vera,5800,0,6,5800,150,FALSE,150,0,1,22500,38.67,High,0.15,5800,870000
Paan Corner,"Godrej Expert Rich Crème, Burgundy",3300,0,6,3300,20,FALSE,20,0,1,400,165,Medium,0.02,3300,66000
Paan Corner,Colgate Gentle Sensitive+ Toothbrush Pack Of 4,12000,10,4,10800,232,FALSE,4,1200,1,928,46.55,High,0.232,10800,43200
Paan Corner,Nivea Creme All Season Multi-Purpose Cream ,17500,10,4,15700,100,FALSE,100,1800,1,10000,157,High,0.1,15700,1570000
Paan Corner,Oral-B Charcoal Deep Clean Stain Removal Toothbrush Medium,9900,0,1,9900,232,FALSE,4,0,1,928,42.67,High,0.232,9900,39600
Paan Corner,Mamaearth 100% Natural Berry Blast Kids Toothpaste,14900,10,4,13400,50,FALSE,50,1500,1,2500,268,High,0.05,13400,670000
Paan Corner,HImalaya Gentle Baby Wipes,20000,10,3,18000,72,FALSE,72,2000,1,5184,250,High,0.072,18000,1296000
Paan Corner,Stayfree Dry Max All Night XL Dry Cover Sanitary Pads,34000,12,6,29800,28,FALSE,28,4200,1,784,1064.29,High,0.028,29800,834400
Paan Corner,"L'Oreal Paris Excellence Creme Hair Color, 1 Black",62000,0,1,62000,172,FALSE,172,0,1,29584,360.47,High,0.172,62000,10664000
Paan Corner,Fem Fairness Naturals Saffron Skin Bleach,8500,15,4,7200,64,FALSE,64,1300,1,4096,112.5,High,0.064,7200,460800
Paan Corner,Engage Woman Blush Body Deo Spray,19500,10,5,17400,150,FALSE,150,2100,1,22500,116,High,0.15,17400,2610000
Paan Corner,Dove Pink Rosa Beauty Bathinhg Bar,6000,0,6,6000,100,FALSE,100,0,1,10000,60,High,0.1,6000,600000
Paan Corner,Sebamed Cleansing Bar,9900,10,4,8900,100,FALSE,100,1000,1,10000,89,High,0.1,8900,890000
Paan Corner,Pampers Premium Care Pants - Large,109900,18,2,89900,44,FALSE,44,20000,1,1936,2043.18,High,0.044,89900,3955600
Paan Corner,Nivea Women Deodorant Fresh Natural Long Lasting Freshness & 48h Protection,19900,20,2,15900,150,FALSE,150,4000,1,22500,106,High,0.15,15900,2385000
Paan Corner,"L'Oreal Paris Excellence Creme Hair Color, 3 Dark Brown/Natural Darkest Brown",62000,0,6,62000,172,FALSE,172,0,1,29584,360.47,High,0.172,62000,10664000
Paan Corner,Patanjali Kesh Kanti Natural Hair Cleanser,7500,9,4,6800,200,FALSE,200,700,1,40000,34,High,0.2,6800,1360000
Paan Corner,Godrej No.1 Bathing Soap  Lime & Aloe Vera,14900,0,6,14900,600,FALSE,600,0,1,360000,24.83,High,0.6,14900,8940000
Paan Corner,Pantene Advanced Control Hair Fall Solution Shampoo,12000,6,5,11200,180,FALSE,180,800,1,32400,62.22,High,0.18,11200,2016000
Paan Corner,Veet Full Body Waxing Kit For Dry Skin,23500,7,6,21800,1160,FALSE,20,1700,1,23200,18.79,High,1.16,21800,436000
Paan Corner,Johnson's Baby Skincare Wipes,24500,9,6,22100,72,FALSE,72,2400,1,5184,306.94,High,0.072,22100,1591200
Paan Corner,Gillette Lemon Lime Shaving Foam,19900,11,4,17700,196,FALSE,196,2200,1,38416,90.31,High,0.196,17700,3469200
Paan Corner,Old Spice After Shave Lotion Musk,21500,6,3,20000,100,FALSE,100,1500,1,10000,200,High,0.1,20000,2000000
Paan Corner,Whisper Ultra Soft Air Fresh Sanitary Pads (XL) with Wings,31500,0,4,31500,30,FALSE,30,0,1,900,1050,High,0.03,31500,945000
Paan Corner,Himalaya Baby Powder,8000,8,4,7300,100,FALSE,100,700,1,10000,73,High,0.1,7300,730000
Paan Corner,Fiama Men's Refreshing Pulse Shower Gel,22500,20,4,18000,250,FALSE,250,4500,1,62500,72,High,0.25,18000,4500000
Paan Corner,Whisper Ultra Clean XL Plus Sanitary Pad,17500,0,5,17500,870,FALSE,15,0,1,13050,20.11,High,0.87,17500,262500
Paan Corner,Johnson's Baby Powder,14300,0,6,14300,200,FALSE,200,0,1,40000,71.5,High,0.2,14300,2860000
Paan Corner,Dove Cream Beauty Bathing Bar,23500,9,6,21200,125,FALSE,125,2300,1,15625,169.6,High,0.125,21200,2650000
Paan Corner,Patanjali Kesh Kanti Shikakai Hair Cleanser,9500,0,4,9500,200,FALSE,200,0,1,40000,47.5,High,0.2,9500,1900000
Paan Corner,L'Oreal Paris Color Protect Conditioner,19900,0,3,19900,192,FALSE,192,0,1,36864,103.65,High,0.192,19900,3820800
Paan Corner,Nivea Men Active Clean with Active Charcoal Shower Gel for Body Face & Hair,19900,4,5,19100,250,FALSE,250,800,1,62500,76.4,High,0.25,19100,4775000
Paan Corner,L'Oreal 6 Oil Nourish Conditioner,13500,0,1,13500,192,FALSE,192,0,1,36864,70.31,High,0.192,13500,2592000
Paan Corner,Godrej Easy Natural Black Hair Colour,2500,0,5,2500,20,FALSE,20,0,1,400,125,Medium,0.02,2500,50000
Paan Corner,Dabur Gulabari Rose Water Daily Glow,8000,6,2,7500,250,FALSE,250,500,1,62500,30,High,0.25,7500,1875000
Paan Corner,Himalaya Purifying Neem Face Wash,17000,10,6,15300,150,FALSE,150,1700,1,22500,102,High,0.15,15300,2295000
Paan Corner,Fem Fairness Naturals Gold Skin Bleach,6500,9,3,5900,24,FALSE,24,600,1,576,245.83,High,0.024,5900,141600
Paan Corner,Whisper Choice Ultra XL Sanitary Pad,13300,2,5,13000,1160,FALSE,20,300,0.9,23200,11.21,High,1.16,13000,260000
Paan Corner,Dove Dandruff Care Shampoo,15800,6,5,14700,180,FALSE,180,1100,1,32400,81.67,High,0.18,14700,2646000
Paan Corner,Head & Shoulders Anti Dandruff Anti Hairfall Shampoo,28500,0,5,28500,340,FALSE,240,0,1,81600,83.82,High,0.34,28500,6840000
Paan Corner,L'Oreal Casting Creme Ebony Black Hair Color,55000,0,6,55000,159,FALSE,87,0,1,13833,345.91,High,0.159,55000,4785000
Paan Corner,Mamaearth Onion Hair Oil,39900,10,6,35900,150,FALSE,150,4000,1,22500,239.33,High,0.15,35900,5385000
Paan Corner,L'Oreal Paris Casting Creme Gloss Hair Color (Dark Brown 400),55000,0,4,55000,159,FALSE,159,0,1,25281,345.91,High,0.159,55000,8745000
Paan Corner,Palmolive Naturals Sea Minerals Liquid Hand Wash,9900,10,6,8900,250,FALSE,250,1000,1,62500,35.6,High,0.25,8900,2225000
Paan Corner,Oral-B Extra Soft Bristles Sensitive ,9800,0,4,9800,232,FALSE,4,0,1,928,42.24,High,0.232,9800,39200
Paan Corner,Engage M3 Perfume Spray for Men,20000,10,3,18000,120,FALSE,120,2000,1,14400,150,High,0.12,18000,2160000
Paan Corner,Mamaearth Deeply Nourishing wash for Babies,19900,0,4,19900,200,FALSE,200,0,1,40000,99.5,High,0.2,19900,3980000
Paan Corner,Dettol Original Soap (B4G1),26000,5,6,24700,625,FALSE,625,1300,1,390625,39.52,High,0.625,24700,15437500
Paan Corner,Woodward's Gripe Water,7500,0,6,7500,200,FALSE,200,0,1,40000,37.5,High,0.2,7500,1500000
Paan Corner,"MamyPoko Pants Extra Absorb Diapers, New Born",29900,6,5,27900,28,FALSE,28,2000,1,784,996.43,High,0.028,27900,781200
Paan Corner,Johnson's Baby Soap,7000,0,6,7000,100,FALSE,100,0,1,10000,70,High,0.1,7000,700000
Paan Corner,Engage M4 Perfume Spray For Men,20000,10,6,18000,120,FALSE,120,2000,1,14400,150,High,0.12,18000,2160000
Paan Corner,Fem Fairness Naturals Hair Removal Cream Fair & Soft - Gold,6500,10,4,5800,40,FALSE,40,700,1,1600,145,High,0.04,5800,232000
Paan Corner,Dove Hair Fall Rescue Conditioner,19000,0,4,19000,175,FALSE,175,0,1,30625,108.57,High,0.175,19000,3325000
Paan Corner,Himalaya Anti Hair Fall Shampoo,13000,12,2,11400,200,FALSE,200,1600,1,40000,57,High,0.2,11400,2280000
Paan Corner,Fiama Peach & Avocado Gel Bar,17600,10,3,15800,375,FALSE,375,1800,1,140625,42.13,High,0.375,15800,5925000
Paan Corner,Pears Pure & Gentle Value Pack Of 4 Bathing Soap ,12500,0,6,12500,75,FALSE,75,0,1,5625,166.67,High,0.075,12500,937500
Paan Corner,Fiama Fresh Hand Wash,15000,6,3,14000,400,FALSE,400,1000,1,160000,35,High,0.4,14000,5600000
Paan Corner,Palmolive Black Orchid And Milk Liquid Hand Wash,9900,10,6,8900,250,FALSE,250,1000,1,62500,35.6,High,0.25,8900,2225000
Paan Corner,Oral-B Criss Cross Medium Toothbrush (Buy 2 Get 2 Free),16000,0,5,16000,232,FALSE,4,0,1,928,68.97,High,0.232,16000,64000
Paan Corner,Gillette Mach 3 Turbo Razor,34900,6,5,32500,58,FALSE,1,2400,1,58,560.34,High,0.058,32500,32500
Paan Corner,Himalaya Baby Lotion,16500,12,3,14500,200,FALSE,200,2000,1,40000,72.5,High,0.2,14500,2900000
Paan Corner,Head & Shoulders 2-in-1 Cool Menthol Anti Dandruff Shampoo + Conditioner,37500,0,1,37500,340,FALSE,180,0,1,61200,110.29,High,0.34,37500,6750000
Paan Corner,Sunsilk Lusciously Thick & Long Shampoo,24900,6,6,23400,340,FALSE,340,1500,1,115600,68.82,High,0.34,23400,7956000
Paan Corner,Fiama Di Wills Men's Refreshing Pulse Shower Gel,22500,4,3,21400,250,FALSE,250,1100,1,62500,85.6,High,0.25,21400,5350000
Paan Corner,Sebamed Anti - Dandruff Shampoo,60000,10,2,54000,200,FALSE,200,6000,1,40000,270,High,0.2,54000,10800000
Paan Corner,Listerine Cool Mint Mouthwash - Mild Taste,15000,10,6,13500,250,FALSE,250,1500,1,62500,54,High,0.25,13500,3375000
Paan Corner,"L'Oreal Paris Excellence Creme Hair Color, 4.25 Aishwarya's Brown",62000,0,6,62000,172,FALSE,172,0,1,29584,360.47,High,0.172,62000,10664000
Paan Corner,Himalaya Gentle Baby Bath,16500,9,6,15000,200,FALSE,200,1500,1,40000,75,High,0.2,15000,3000000
Paan Corner,"L'Oreal Paris Casting Creme Gloss Hair Color, Medium Brown 500",55000,0,4,55000,160,FALSE,159,0,1,25440,343.75,High,0.16,55000,8745000
Paan Corner,L'Oreal Paris Color Protect Shampoo,28200,0,3,28200,360,FALSE,360,0,1,129600,78.33,High,0.36,28200,10152000
Paan Corner,Fiama Di Wills Lemongrass & Jojoba Gel Bar,17600,10,6,15800,375,FALSE,375,1800,1,140625,42.13,High,0.375,15800,5925000
Paan Corner,Colgate Plax Peppermint Mouthwash,15000,20,5,12000,250,FALSE,250,3000,1,62500,48,High,0.25,12000,3000000
Paan Corner,Dove Daily Shine Conditioner,9000,10,1,8100,80,FALSE,80,900,1,6400,101.25,High,0.08,8100,648000
Paan Corner,Patanjali Kesh Kanti Anti Dandruff Hair Cleanser,11000,0,6,11000,200,FALSE,200,0,1,40000,55,High,0.2,11000,2200000
Paan Corner,Old Spice Original After Shave Lotion,25000,0,1,25000,150,FALSE,150,0,1,22500,166.67,High,0.15,25000,3750000
Paan Corner,Dove Hair Fall Rescue Shampoo,13700,10,4,12300,180,FALSE,180,1400,1,32400,68.33,High,0.18,12300,2214000
Paan Corner,Dettol Clinical Strength Hand Sanitizer Liquid,25000,10,6,22500,500,FALSE,500,2500,1,250000,45,High,0.5,22500,11250000
Paan Corner,Nivea Soft Light Moisturizer for Face Hand & Body Non-Sticky Cream with Vitamin E & Jojoba Oil,39900,20,3,31900,300,FALSE,300,8000,1,90000,106.33,High,0.3,31900,9570000
Paan Corner,Comfy Baby Pants XL 12-17 kg,42900,15,1,36400,24,FALSE,24,6500,1,576,1516.67,High,0.024,36400,873600
Paan Corner,Dettol Liquid Handwash With Free Liquid,9900,0,6,9900,200,FALSE,200,0,1,40000,49.5,High,0.2,9900,1980000
Paan Corner,Nivea Body Milk Lotion for Very Dry Skin,39900,20,6,31900,400,FALSE,400,8000,1,160000,79.75,High,0.4,31900,12760000
Paan Corner,Lakme Sun Expert,22500,0,6,22500,60,FALSE,60,0,1,3600,375,High,0.06,22500,1350000
Paan Corner,Head & shoulders Anti Dandruff Shampoo Cool Menthol,17000,0,6,17000,180,FALSE,180,0,1,32400,94.44,High,0.18,17000,3060000
Paan Corner,Godrej Nupur Henna,7500,0,5,7500,150,FALSE,120,0,1,18000,50,High,0.15,7500,900000
Paan Corner,Johnson's Baby Lotion,10000,0,4,10000,100,FALSE,100,0,1,10000,100,High,0.1,10000,1000000
Paan Corner,Himalaya Anti Dandruff Shampoo,14000,10,1,12600,200,FALSE,200,1400,1,40000,63,High,0.2,12600,2520000
Paan Corner,Maybelline New York Colossal Kajal Super Black,30000,8,3,27500,0,FALSE,0,2500,1,0,#DIV/0!,High,0,27500,0
Paan Corner,Stayfree Dry-Max All Night Ultra-Dry Sanitary Pad,9000,10,6,8100,406,FALSE,7,900,1,2842,19.95,High,0.406,8100,56700
Paan Corner,Dove Daily Shine Shampoo,64500,5,3,61200,650,FALSE,650,3300,1,422500,94.15,High,0.65,61200,39780000
Paan Corner,Godrej Easy 5 Minute Natural Brown 4 Hair Colour,2900,0,5,2900,20,FALSE,20,0,1,400,145,Medium,0.02,2900,58000
Paan Corner,Colgate Sensitive Plus Enamel Toothpaste Tube,14000,0,6,14000,160,FALSE,160,0,1,25600,87.5,High,0.16,14000,2240000
Paan Corner,Colgate Max Fresh Peppermint Toothpaste ,18200,15,6,15400,300,FALSE,300,2800,1,90000,51.33,High,0.3,15400,4620000
Paan Corner,Pond's Light Moisturiser,30900,10,6,27800,250,FALSE,250,3100,1,62500,111.2,High,0.25,27800,6950000
Paan Corner,Engage Mate For Man Deo Spray,19500,10,5,17400,150,FALSE,150,2100,1,22500,116,High,0.15,17400,2610000
Paan Corner,Pantene Advanced Hair Fall Solution Shampoo - Total Damage Care,12000,0,5,12000,180,FALSE,180,0,1,32400,66.67,High,0.18,12000,2160000
Paan Corner,Whisper Choice Regular Wing Sanitary Pad,3000,0,2,3000,406,FALSE,7,0,0.9,2842,7.39,Medium,0.406,3000,21000
Paan Corner,Colgate Slim Soft Charcoal Toothbrush,15000,18,4,12300,232,FALSE,4,2700,1,928,53.02,High,0.232,12300,49200
Paan Corner,Fiama Scents Juniper & Geranium Body Wash,19900,6,5,18600,250,FALSE,250,1300,1,62500,74.4,High,0.25,18600,4650000
Paan Corner,Mamaearth Ubtan Body Lotion,39900,15,4,33900,400,FALSE,400,6000,1,160000,84.75,High,0.4,33900,13560000
Paan Corner,Godrej Aer Power Pocket - Long Lasting Bathroom Fragrance Floral Delight,5500,0,6,5500,10,FALSE,10,0,1,100,550,High,0.01,5500,55000
Paan Corner,Himalaya Anti-Hair Fall Shampoo,23000,18,1,18800,400,FALSE,400,4200,1,160000,47,High,0.4,18800,7520000
Paan Corner,Nivea Soft Light Moisturizer for Face Hand & Body Non-Sticky Cream with Vitamin E & Jojoba Oil,31000,15,6,26300,200,FALSE,200,4700,1,40000,131.5,High,0.2,26300,5260000
Paan Corner,Engage M2 Perfume Spray For Men,20000,10,6,18000,120,FALSE,120,2000,1,14400,150,High,0.12,18000,2160000
Paan Corner,Mamaearth Ubtan Face Scrub Turmeric & Walnut,34900,10,1,31400,100,FALSE,100,3500,1,10000,314,High,0.1,31400,3140000
Paan Corner,Himalaya Purifying Neem Face Wash Tube,27000,15,6,22900,300,FALSE,300,4100,1,90000,76.33,High,0.3,22900,6870000
Paan Corner,Johnson's Baby Top To Toe Bath Body Wash,16500,0,4,16500,210,FALSE,210,0,1,44100,78.57,High,0.21,16500,3465000
Paan Corner,Gillette Mach 3 Start,24900,0,6,24900,116,FALSE,2,0,1,232,214.66,High,0.116,24900,49800
Paan Corner,Scalpe Pro Anti dandruff Shampoo 100ml,18500,0,2,18500,100,FALSE,100,0,1,10000,185,High,0.1,18500,1850000
Paan Corner,Johnson's Baby Cream,15000,0,6,15000,100,FALSE,100,0,1,10000,150,High,0.1,15000,1500000
Paan Corner,Johnson's Baby Soap,10500,0,6,10500,150,FALSE,150,0,1,22500,70,High,0.15,10500,1575000
Paan Corner,Himalaya Gentle Baby Shampoo,32000,17,6,26500,400,FALSE,400,5500,1,160000,66.25,High,0.4,26500,10600000
Paan Corner,L'Oreal Paris Shine Masque Royal Jelly Hair Colour,55000,0,3,55000,88,FALSE,87,0,1,7656,625,High,0.088,55000,4785000
Paan Corner,Engage Rush Deodorant For Men,19000,11,6,16900,150,FALSE,150,2100,1,22500,112.67,High,0.15,16900,2535000
Paan Corner,Clean & Clear Foaming Face Wash,14000,10,4,12600,100,FALSE,100,1400,1,10000,126,High,0.1,12600,1260000
Paan Corner,Dettol Lather Shaving Cream,7500,5,6,7100,78,FALSE,78,400,1,6084,91.03,High,0.078,7100,553800
Paan Corner,Gillette Classic Regular Pre Shave Foam,19900,0,4,19900,196,FALSE,196,0,1,38416,101.53,High,0.196,19900,3900400
Paan Corner,Dove Daily Shine Conditioner,19000,0,6,19000,175,FALSE,180,0,1,31500,108.57,High,0.175,19000,3420000
Paan Corner,Johnson's Baby Shampoo,18000,0,6,18000,200,FALSE,200,0,1,40000,90,High,0.2,18000,3600000
Paan Corner,Park Avenue Beer Shampoo ,15500,9,4,14000,180,FALSE,180,1500,1,32400,77.78,High,0.18,14000,2520000
Paan Corner,Pantene Advanced Hair Fall Solution Silky Smooth Care Shampoo,12000,6,6,11200,180,FALSE,180,800,1,32400,62.22,High,0.18,11200,2016000
Paan Corner,Fem Fairness Naturals Hair Removal Cream Fair & Soft - Rose,6500,10,6,5800,40,FALSE,40,700,1,1600,145,High,0.04,5800,232000
Paan Corner,Sunsilk Stunning Black Shine Shampoo,55500,6,6,52100,650,FALSE,650,3400,1,422500,80.15,High,0.65,52100,33865000
Paan Corner,Dabur Meswak Toothpaste,10000,0,1,10000,200,FALSE,200,0,1,40000,50,High,0.2,10000,2000000
Paan Corner,Patanjali Kesh Kanti Reetha Hair Cleanser,8500,0,5,8500,200,FALSE,200,0,1,40000,42.5,High,0.2,8500,1700000
Paan Corner,Nivea Lip Balm Soft Rose for 24h Moisture with Natural Oils Delicate Rose Shine,18500,8,6,16900,5,FALSE,4,1600,1,20,3380,High,0.005,16900,67600
Paan Corner,Santoor Total Skin Care Soap With Sandal & Turmeric,18000,0,6,18000,600,FALSE,600,0,1,360000,30,High,0.6,18000,10800000
Paan Corner,"L'Oreal Paris Excellence Creme Hair Color, 4 Natural Brown/Natural Dark Brown",62000,0,1,62000,172,FALSE,172,0,1,29584,360.47,High,0.172,62000,10664000
Paan Corner,Gillette Pre Shave Foam - Classic Regular Skin,22500,0,6,22500,418,FALSE,418,0,1,174724,53.83,High,0.418,22500,9405000
Paan Corner,Fiama Di Wills Shower Gel Patchouli & Macadamia,19900,10,6,17900,250,FALSE,250,2000,1,62500,71.6,High,0.25,17900,4475000
Paan Corner,Listerine Fresh Burst Mouthwash,14000,10,4,12600,250,FALSE,250,1400,1,62500,50.4,High,0.25,12600,3150000
Paan Corner,Nivea Cocoa Nourish Body Lotion With Coconut Oil & Cocoa Butter For Very Dry Skin ,29900,17,5,24700,200,FALSE,200,5200,1,40000,123.5,High,0.2,24700,4940000
Paan Corner,Pantene Hair Fall Control Shampoo,24000,7,2,22100,340,FALSE,340,1900,1,115600,65,High,0.34,22100,7514000
Paan Corner,Fogg Master - Royal Intense,25000,0,5,25000,120,FALSE,120,0,1,14400,208.33,High,0.12,25000,3000000
Paan Corner,TRESemme Smooth And Shine Conditioner,22000,0,5,22000,190,FALSE,190,0,1,36100,115.79,High,0.19,22000,4180000
Paan Corner,Whisper Ultra Clean XL Plus Sanitary Pad,15500,0,6,15500,870,FALSE,15,0,0.9,13050,17.82,High,0.87,15500,232500
Paan Corner,"Colgate Kids Toothpaste - 6+ Years, Strawberry Flavour",9300,5,6,8800,80,FALSE,80,500,1,6400,110,High,0.08,8800,704000
Paan Corner,Nivea Soft Moisturizing Cream,31000,12,1,27200,200,FALSE,200,3800,1,40000,136,High,0.2,27200,5440000
Paan Corner,Patanjali Kesh Kanti Aloe Vera Hair Cleanser,8500,0,5,8500,200,FALSE,200,0,1,40000,42.5,High,0.2,8500,1700000
Paan Corner,Neutrogena Deep Clean Foaming Cleanser,13000,11,2,11500,50,FALSE,50,1500,1,2500,230,High,0.05,11500,575000
Paan Corner,Clean & Clear Morning Energy Berry Face Wash,15500,6,6,14500,100,FALSE,100,1000,1,10000,145,High,0.1,14500,1450000
Paan Corner,Pampers Premium Care New Baby Pants,32000,0,4,32000,24,FALSE,24,0,1,576,1333.33,High,0.024,32000,768000
Paan Corner,Vaseline Intensive Care Aloe Fresh,22500,9,6,20300,200,FALSE,200,2200,1,40000,101.5,High,0.2,20300,4060000
Paan Corner,L'Oreal Paris Dream Lengths Shampoo,14900,0,6,14900,192,FALSE,192,0,1,36864,77.6,High,0.192,14900,2860800
Paan Corner,Johnson's Baby Oil,11500,0,4,11500,100,FALSE,100,0,1,10000,115,High,0.1,11500,1150000
Paan Corner,Engage Man Rush Deodorant,19500,9,6,17600,150,FALSE,150,1900,1,22500,117.33,High,0.15,17600,2640000
Paan Corner,Pantene Advanced Hair Fall Solution Shampoo - Total Damage Care,26400,0,6,26400,340,FALSE,340,0,1,115600,77.65,High,0.34,26400,8976000
Paan Corner,Whisper Daily Liners Clean and Fresh,10500,0,4,10500,1160,FALSE,20,0,0.9,23200,9.05,High,1.16,10500,210000
Paan Corner,Himalaya Men Pimple Clear Neem Face Wash,18000,9,2,16300,100,FALSE,100,1700,1,10000,163,High,0.1,16300,1630000
Paan Corner,Pantene Adv Hairfall Solution Conditioner Silky Smooth,19000,0,5,19000,200,FALSE,200,0,1,40000,95,High,0.2,19000,3800000
Paan Corner,Himalaya Prickly Heat Baby Powder,9000,10,6,8100,100,FALSE,100,900,1,10000,81,High,0.1,8100,810000
Paan Corner,Mamaearth Daily Moisturizing Lotion For Babies,19900,0,6,19900,200,FALSE,200,0,1,40000,99.5,High,0.2,19900,3980000
Paan Corner,Stayfree Advanced XL Ultra Comfort Sanitary napkins with Wings,17500,0,3,17500,812,FALSE,14,0,1,11368,21.55,High,0.812,17500,245000
Paan Corner,Pampers Premium Care Pants - Medium,109900,18,6,89900,54,FALSE,54,20000,1,2916,1664.81,High,0.054,89900,4854600
Paan Corner,Fiama Men's Refreshing Pulse Shower Gel,19900,10,6,17900,250,FALSE,250,2000,1,62500,71.6,High,0.25,17900,4475000
Paan Corner,Vaseline Original Skin Protecting Jelly,12500,10,6,11200,100,FALSE,100,1300,1,10000,112,High,0.1,11200,1120000
Paan Corner,Clean & Clear Foaming Face Wash,18000,10,6,16200,150,FALSE,150,1800,1,22500,108,High,0.15,16200,2430000
Paan Corner,Fiama Lemongrass and Jojoba Shower Gel,22500,20,6,18000,250,FALSE,250,4500,1,62500,72,High,0.25,18000,4500000
Paan Corner,Oral-B Charcoal Cross Cross Extra Soft Toothbrush (Buy 2 Get 1 Free),18000,0,1,18000,174,FALSE,3,0,1,522,103.45,High,0.174,18000,54000
Paan Corner,Listerine Fresh Burst Mouthwash,28500,7,6,26300,500,FALSE,500,2200,1,250000,52.6,High,0.5,26300,13150000
Paan Corner,Veet Full Body Waxing Kit,23500,7,6,21800,1160,FALSE,20,1700,1,23200,18.79,High,1.16,21800,436000
Paan Corner,Listerine Original Mouthwash,5500,9,6,5000,80,FALSE,80,500,1,6400,62.5,High,0.08,5000,400000
Paan Corner,Santoor Almond Soft With Sandal & Almond Milk,18000,0,2,18000,625,FALSE,625,0,1,390625,28.8,High,0.625,18000,11250000
Paan Corner,Nivea Body Shea Smooth with Shea Butter for Dry Skin,42500,20,5,34000,400,FALSE,9,8500,1,3600,85,High,0.4,34000,306000
Paan Corner,Neutrogena Deep Clean Facial Cleanser,13000,0,4,13000,50,FALSE,50,0,1,2500,260,High,0.05,13000,650000
Paan Corner,"L'Oreal Paris Excellence Creme Hair Color, 3.16 Burgundy",55000,0,3,55000,159,FALSE,172,0,1,27348,345.91,High,0.159,55000,9460000
Paan Corner,Johnson's Baby Powder,23500,0,6,23500,400,FALSE,400,0,1,160000,58.75,High,0.4,23500,9400000
Paan Corner,Bombay Shaving Company Charcoal Face Wash,24900,0,4,24900,100,FALSE,100,0,1,10000,249,High,0.1,24900,2490000
Paan Corner,Colgate Kids 2+ Years Extra Soft Toothbrush,2000,0,3,2000,58,FALSE,1,0,1,58,34.48,Medium,0.058,2000,2000
Paan Corner,Veet Hair Removal Cream (Normal Skin),13500,5,6,12800,50,FALSE,50,700,1,2500,256,High,0.05,12800,640000
Paan Corner,Dove Daily Shine Shampoo,24000,0,4,24000,340,FALSE,340,0,1,115600,70.59,High,0.34,24000,8160000
Paan Corner,L'Oreal Anti Hair Fall Conditioner,19900,0,6,19900,192,FALSE,192,0,1,36864,103.65,High,0.192,19900,3820800
Paan Corner,Nivea Body Lotion Aloe Hydration For Normal Skin ,27500,10,6,24700,200,FALSE,200,2800,1,40000,123.5,High,0.2,24700,4940000
Paan Corner,Pampers Pants - Large,154900,45,3,84900,82,FALSE,82,70000,1,6724,1035.37,High,0.082,84900,6961800
Paan Corner,"Engage Urge Deodorant For Men, Citrus And Woody, Skin Friendly",19500,10,6,17400,150,FALSE,150,2100,1,22500,116,High,0.15,17400,2610000
Paan Corner,Head & Shoulders 2 In 1 Anti Dandruff Smooth & Silky Shampoo+Conditioner,37500,10,6,33400,340,FALSE,340,4100,1,115600,98.24,High,0.34,33400,11356000
Paan Corner,Fem Fairness Natural Gold Skin Bleach,8500,7,4,7900,64,FALSE,64,600,1,4096,123.44,High,0.064,7900,505600
Paan Corner,Engage Deo Frost,19500,9,6,17600,150,FALSE,150,1900,1,22500,117.33,High,0.15,17600,2640000
Paan Corner,Stayfree Secure XL Size Sanitary Napkins,11500,0,5,11500,1160,FALSE,20,0,0.9,23200,9.91,High,1.16,11500,230000
Paan Corner,Pampers Pants - Medium,69900,21,1,54900,50,FALSE,50,15000,1,2500,1098,High,0.05,54900,2745000
Paan Corner,Pampers Active Baby Diapers New Born Extra Small ,109900,22,3,84900,72,FALSE,72,25000,1,5184,1179.17,High,0.072,84900,6112800
Paan Corner,"Nivea Creme, All Season Multi-Purpose Cream",17500,9,6,15800,100,FALSE,100,1700,1,10000,158,High,0.1,15800,1580000
Paan Corner,Woodwards Gripe Water ,5000,0,4,5000,130,FALSE,130,0,1,16900,38.46,High,0.13,5000,650000
Paan Corner,Clean & Clear Morning Energy Aqua Splash Face Wash,14500,9,5,13100,100,FALSE,100,1400,1,10000,131,High,0.1,13100,1310000
Paan Corner,Sunsilk Lusciously Thick & Long Shampoo,55500,6,6,52100,650,FALSE,650,3400,1,422500,80.15,High,0.65,52100,33865000
Paan Corner,Mamaearth Skin Correct Face Serum,59900,15,1,50900,30,FALSE,30,9000,1,900,1696.67,High,0.03,50900,1527000
Paan Corner,Chik Hairfall Prevent Egg Shampoo,17800,0,6,17800,340,FALSE,340,0,1,115600,52.35,High,0.34,17800,6052000
Paan Corner,Pantene Silky Smooth Care Shampoo,22500,6,3,21000,340,FALSE,340,1500,1,115600,61.76,High,0.34,21000,7140000
Paan Corner,"Garnier Skin Naturals, Micellar Cleansing Water",19900,5,4,18900,125,FALSE,125,1000,1,15625,151.2,High,0.125,18900,2362500
Paan Corner,Set Wet Swag Avatar Deodorant & Body Spray Perfume For Men,19900,0,1,19900,150,FALSE,150,0,1,22500,132.67,High,0.15,19900,2985000
Paan Corner,Pampers All Round Protection Pants - Medium,69900,17,6,57500,50,FALSE,50,12400,1,2500,1150,High,0.05,57500,2875000
Paan Corner,Set Wet Deodrant Charm Avatar,19900,0,1,19900,150,FALSE,150,0,1,22500,132.67,High,0.15,19900,2985000
Paan Corner,Nupur Heena Mehandi,19900,0,6,19900,500,FALSE,500,0,1,250000,39.8,High,0.5,19900,9950000
Paan Corner,Head & Shoulders 2-in-1 Active Protect Shampoo,37500,9,6,33800,340,FALSE,340,3700,1,115600,99.41,High,0.34,33800,11492000
Paan Corner,Gillette Mach 3 Turbo Cartridges,64900,10,6,57800,232,FALSE,4,7100,1,928,249.14,High,0.232,57800,231200
Paan Corner,TRESemme Smooth And Shine Conditioner,21000,13,1,18200,190,FALSE,190,2800,1,36100,95.79,High,0.19,18200,3458000
Paan Corner,Bombay Shaving Company Sensitive Cartridges,37500,0,2,37500,116,FALSE,2,0,1,232,323.28,High,0.116,37500,75000
Paan Corner,Himalaya Baby Lotion,30000,12,1,26400,400,FALSE,400,3600,1,160000,66,High,0.4,26400,10560000
Paan Corner,Old Spice Lime Lather Shaving Cream,7500,0,6,7500,70,FALSE,70,0,1,4900,107.14,High,0.07,7500,525000
Paan Corner,Colgate Sensitive Plus Anticavity Toothpaste ,14000,10,6,12600,70,FALSE,70,1400,1,4900,180,High,0.07,12600,882000
Paan Corner,Colgate Toothpaste For Kids Motu Oatlu,9300,0,6,9300,80,FALSE,80,0,1,6400,116.25,High,0.08,9300,744000
Paan Corner,Pantene Total Damage Care Shampoo,12000,0,6,12000,180,FALSE,180,0,1,32400,66.67,High,0.18,12000,2160000
Paan Corner,Himalaya Moisturising Aloe Vera Facial Wipes,10000,10,6,9000,25,FALSE,25,1000,1,625,360,High,0.025,9000,225000
Paan Corner,Savlon Moisture Shield Hand Wash,6900,0,5,6900,200,FALSE,200,0,1,40000,34.5,High,0.2,6900,1380000
Paan Corner,Pampers Active Baby Diapers New Born Extra Small,36000,10,6,32400,24,FALSE,24,3600,1,576,1350,High,0.024,32400,777600
Paan Corner,Himalaya Anti Dandruff Shampoo,26000,18,1,21300,400,FALSE,400,4700,1,160000,53.25,High,0.4,21300,8520000
Paan Corner,Himalaya Anti Hair Fall Shampoo,49000,25,4,36700,700,FALSE,700,12300,1,490000,52.43,High,0.7,36700,25690000
Paan Corner,Johnson's Baby Oil,20000,0,6,20000,200,FALSE,200,0,1,40000,100,High,0.2,20000,4000000
Paan Corner,Vaseline Intensive Care Deep Moisture Body Lotion,32500,0,4,32500,400,FALSE,400,0,1,160000,81.25,High,0.4,32500,13000000
Paan Corner,L'Oreal Paris Dream Lengths Conditioner,19900,0,1,19900,193,FALSE,193,0,1,37249,103.11,High,0.193,19900,3840700
Paan Corner,Nivea Soft Light Moisturizing Cream,18500,15,6,15700,100,FALSE,100,2800,1,10000,157,High,0.1,15700,1570000
Paan Corner,Whisper Ultra Soft XL+ Sanitary Pads,55500,0,1,55500,60,FALSE,60,0,1,3600,925,High,0.06,55500,3330000
Paan Corner,Palmolive Feel The Massage Shower Gel,24900,20,6,19900,250,FALSE,250,5000,1,62500,79.6,High,0.25,19900,4975000
Paan Corner,L'Oreal Paris Dream Lengths Conditioner,20900,0,3,20900,193,FALSE,193,0,1,37249,108.29,High,0.193,20900,4033700
Paan Corner,Head & Shoulders Anti-Dandruff Smooth & Silky Shampoo,28500,6,6,26600,340,FALSE,340,1900,1,115600,78.24,High,0.34,26600,9044000
Paan Corner,Mamaearth Moisturizing Baby Bath Soap,24900,0,4,24900,150,FALSE,150,0,1,22500,166,High,0.15,24900,3735000
Paan Corner,Listerine Original Mouthwash,15000,10,6,13500,250,FALSE,250,1500,1,62500,54,High,0.25,13500,3375000
Paan Corner,Himalaya Gentle Baby Shampoo,17000,14,6,14600,200,FALSE,200,2400,1,40000,73,High,0.2,14600,2920000
Paan Corner,Dove Dryness Care Shampoo,26800,5,1,25200,340,FALSE,340,1600,1,115600,74.12,High,0.34,25200,8568000
Paan Corner,Dove Hair Fall Rescue Shampoo,28000,15,6,23600,340,FALSE,340,4400,1,115600,69.41,High,0.34,23600,8024000
Paan Corner,Head & Shoulders Anti Dandruff Shampoo Cool Menthol,29500,9,6,26600,340,FALSE,340,2900,1,115600,78.24,High,0.34,26600,9044000
Paan Corner,Bombay Shaving Company Defender Razor,34500,0,6,34500,58,FALSE,1,0,1,58,594.83,High,0.058,34500,34500
Paan Corner,"Head & Shoulders Shampoo + Conditioner - 2-In-1, Cool Menthol",36500,0,1,36500,340,FALSE,340,0,1,115600,107.35,High,0.34,36500,12410000
Paan Corner,Himalaya Baby Nourishing Massage Oil,20000,20,2,16000,200,FALSE,250,4000,1,50000,80,High,0.2,16000,4000000
Paan Corner,Himalaya Baby Powder,23500,20,6,18800,400,FALSE,400,4700,1,160000,47,High,0.4,18800,7520000
Paan Corner,Fogg Paradise Fragrant Body Spray For Women ,25000,0,6,25000,150,FALSE,150,0,1,22500,166.67,High,0.15,25000,3750000
Paan Corner,Revive Revive Liquid,7100,0,6,7100,200,FALSE,200,0,1,40000,35.5,High,0.2,7100,1420000
Paan Corner,Pantene Hairfall Control Conditioner,19000,6,6,17800,200,FALSE,200,1200,1,40000,89,High,0.2,17800,3560000
Paan Corner,Mamaearth Vitamin C Face Toner,39900,0,1,39900,200,FALSE,200,0,1,40000,199.5,High,0.2,39900,7980000
Paan Corner,Himalaya Diaper Rash Cream,8000,10,2,7200,20,FALSE,20,800,1,400,360,High,0.02,7200,144000
Paan Corner,Fogg Royal Fragrance Spray,23000,0,4,23000,150,FALSE,120,0,1,18000,153.33,High,0.15,23000,2760000
Paan Corner,Dove Pink Rosa Beauty Bathing Bar,24500,9,6,22100,100,FALSE,100,2400,1,10000,221,High,0.1,22100,2210000
Paan Corner,Dove Dryness Care Conditioner Frizzy & Dry Hair,9000,6,4,8400,80,FALSE,80,600,1,6400,105,High,0.08,8400,672000
Paan Corner,Dettol Original Liquid Handwash Refill,10900,3,0,10500,750,TRUE,750,400,0.9,562500,14,High,0.75,10500,7875000
Paan Corner,Parachute 100% Pure Coconut Oil,12300,0,0,12300,300,TRUE,300,0,1,90000,41,High,0.3,12300,3690000
Paan Corner,Stayfree Secure Cottony Soft Cover Sanitary Pad (Regular) with Wings,3000,3,0,2900,406,TRUE,7,100,0.9,2842,7.14,Medium,0.406,2900,20300
Paan Corner,Dabur Gulabari Premium Rose Water,4800,2,0,4700,120,TRUE,120,100,1,14400,39.17,High,0.12,4700,564000
Paan Corner,Parachute Advansed Gold Coconut Hair Oil,21500,9,0,19400,400,TRUE,400,2100,1,160000,48.5,High,0.4,19400,7760000
Paan Corner,Closeup Everfresh+ Anti-Germ Gel Toothpaste Red Hot,9000,10,0,8100,150,TRUE,150,900,1,22500,54,High,0.15,8100,1215000
Paan Corner,Godrej No.1 Bathing Soap  Lime & Aloe Vera,10000,16,0,8400,500,TRUE,100,1600,1,50000,16.8,High,0.5,8400,840000
Paan Corner,Sensodyne Sensitive Fresh Gel Toothpaste,11500,7,0,10600,75,TRUE,75,900,1,5625,141.33,High,0.075,10600,795000
Paan Corner,Whisper Bindazzz Nights XL + Sanitary Pad,9000,0,0,9000,406,TRUE,7,0,1,2842,22.17,High,0.406,9000,63000
Paan Corner,Whisper Choice Sanitary Pad ,3200,9,0,2900,406,TRUE,7,300,0.9,2842,7.14,Medium,0.406,2900,20300
Paan Corner,"Godrej No.1 Bathing Soap, Jasmine",8400,0,0,8400,400,TRUE,100,0,1,40000,21,High,0.4,8400,840000
Paan Corner,Gillette Venus Close & Clean Razor ,24900,7,0,23000,58,TRUE,1,1900,1,58,396.55,High,0.058,23000,23000
Paan Corner,Whisper Choice Regular Sanitary Pads,9000,3,0,8700,58,TRUE,20,300,1,1160,150,High,0.058,8700,174000
Paan Corner,Stayfree Secure Dry Cover Extra Large Sanitary Pad,4200,2,0,4100,406,TRUE,7,100,0.9,2842,10.1,High,0.406,4100,28700
Paan Corner,Oxylife Natural Radiance 5 Creme Bleach - With Active Oxygen,8200,9,0,7400,27,TRUE,27,800,1,729,274.07,High,0.027,7400,199800
Paan Corner,Clean & Clear Morning Energy Lemon Face Wash,14500,9,0,13100,100,TRUE,100,1400,1,10000,131,High,0.1,13100,1310000
Paan Corner,Bajaj Almond Drops Hair Oil,6700,10,0,6000,100,TRUE,100,700,1,10000,60,High,0.1,6000,600000
Paan Corner,Bajaj Almond Drops Hair Oil Bottle,13000,7,0,12000,200,TRUE,200,1000,1,40000,60,High,0.2,12000,2400000
Paan Corner,Whisper Bindazzz Night Sanitary Pads XL Plus,18500,0,0,18500,870,TRUE,15,0,1,13050,21.26,High,0.87,18500,277500
Paan Corner,Godrej Cinthol Lime Refreshing Deo Soap,11600,0,0,11600,400,TRUE,400,0,1,160000,29,High,0.4,11600,4640000
Paan Corner,"MamyPoko Pants Standard Diapers, Extra Large (12 - 17 kg)",39900,7,0,36900,26,TRUE,26,3000,1,676,1419.23,High,0.026,36900,959400
Home & Cleaning,Surf Excel Stain Eraser,1800,0,1,1800,150,FALSE,150,0,0.9,22500,12,Low,0.15,1800,270000
Home & Cleaning,Colin Glass and Surface Cleaner Liquid Spray Regular,9600,7,6,8900,500,FALSE,500,700,0.9,250000,17.8,High,0.5,8900,4450000
Home & Cleaning,A1 Biodegradable Garbage Dustbin Bags,6900,0,6,6900,30,FALSE,30,0,1,900,230,High,0.03,6900,207000
Home & Cleaning,"Mortein Cockroach Killer Spray, Crawling insect killer with Deep-Reach Nozzle",18900,5,2,17900,425,FALSE,425,1000,1,180625,42.12,High,0.425,17900,7607500
Home & Cleaning,Pril Perfect Lime Dishwash Liquid,19000,7,4,17500,750,FALSE,750,1500,1,562500,23.33,High,0.75,17500,13125000
Home & Cleaning,Dettol Antiseptic Disinfectant Liquid,6600,0,6,6600,125,FALSE,125,0,1,15625,52.8,High,0.125,6600,825000
Home & Cleaning,Godrej Aer Power Pocket Berry Rush,5500,0,3,5500,10,FALSE,10,0,1,100,550,High,0.01,5500,55000
Home & Cleaning,Hit Cockroach Killer Spray ,10100,2,4,9800,200,FALSE,200,300,1,40000,49,High,0.2,9800,1960000
Home & Cleaning,Vim Dishwash Liquid Gel Lemon,18500,5,1,17500,750,FALSE,750,1000,1,562500,23.33,High,0.75,17500,13125000
Home & Cleaning,"Harpic Disinfectant Toilet Cleaner Liquid, Original - 1 L",17800,0,6,17800,1000,FALSE,1,0,0.9,1000,17.8,High,1,17800,17800
Home & Cleaning,Odomos Mosquito Repellent Cream ,5000,8,6,4600,50,FALSE,50,400,1,2500,92,High,0.05,4600,230000
Home & Cleaning,Harpic Disinfectant Bathroom Cleaner Liquid Lemon,18900,5,6,17900,1000,FALSE,1,1000,0.9,1000,17.9,High,1,17900,17900
Home & Cleaning,Eveready AA pack of 10 ,15000,4,6,14300,580,FALSE,10,700,1,5800,24.66,High,0.58,14300,143000
Home & Cleaning,Cherry Blossom Liquid Wax Polish,9800,5,6,9300,75,FALSE,75,500,1,5625,124,High,0.075,9300,697500
Home & Cleaning,Gala Scrubber Cleaner Home Everyday Scrub,3500,2,6,3400,58,FALSE,1,100,1,58,58.62,Medium,0.058,3400,3400
Home & Cleaning,Hit Flower Lime Fragrance Insect Killer Spray,18200,3,6,17600,400,FALSE,400,600,1,160000,44,High,0.4,17600,7040000
Home & Cleaning,Harpic Hygienic Toilet Cleaner Rim Block Jasmine,8200,6,4,7700,26,FALSE,26,500,1,676,296.15,High,0.026,7700,200200
Home & Cleaning,Om Bhakti - Pancha Deepa Oil ,19900,10,6,17900,1000,FALSE,1,2000,0.9,1000,17.9,High,1,17900,17900
Home & Cleaning,Ariel Complete Detergent Washing Powder 500 g  + 200 g Free,13500,0,6,13500,500,FALSE,500,0,1,250000,27,High,0.5,13500,6750000
Home & Cleaning,Surf Excel Matic Top Load Detergent Powder,20000,6,1,18800,1000,FALSE,1,1200,1,1000,18.8,High,1,18800,18800
Home & Cleaning,Harpic Flushmatic In-Cistern Toilet Cleaner Blocks Marine,15400,7,4,14300,100,FALSE,100,1100,1,10000,143,High,0.1,14300,1430000
Home & Cleaning,Eveready 1012 Carbon Zinc AAA Battery,15000,4,2,14300,580,FALSE,10,700,1,5800,24.66,High,0.58,14300,143000
Home & Cleaning,Surf Excel Matic Front Load Detergent Liquid,22500,1,6,22100,1000,FALSE,1,400,1,1000,22.1,High,1,22100,22100
Home & Cleaning,Origami Kitchen Towels 2 In 1 Quilted 2ply,14000,10,6,12600,116,FALSE,2,1400,1,232,108.62,High,0.116,12600,25200
Home & Cleaning,Oxi Green Phenyl - Pine ,8200,9,6,7400,1000,FALSE,1,800,0.9,1000,7.4,High,1,7400,7400
Home & Cleaning,Surf Excel Easy Wash Detergent Liquid,17000,0,6,16900,1000,FALSE,1,100,0.9,1000,16.9,High,1,16900,16900
Home & Cleaning,Uno Playing Card Game,14900,9,2,13500,58,FALSE,1,1400,1,58,232.76,High,0.058,13500,13500
Home & Cleaning,Chakaachak Mini Cloth Brush,4000,2,1,3900,58,FALSE,1,100,1,58,67.24,High,0.058,3900,3900
Home & Cleaning,Chakaachak Super Scrub Pad (Pack of 3),3500,2,2,3400,174,FALSE,3,100,1,522,19.54,Medium,0.174,3400,10200
Home & Cleaning,Colin Glass and Surface Cleaner Liquid Spray Regular,6200,6,5,5800,250,FALSE,250,400,1,62500,23.2,High,0.25,5800,1450000
Home & Cleaning,Om Bhakti Cow Dung Cakes ,1600,0,6,1600,290,FALSE,5,0,0.8,1450,5.52,Low,0.29,1600,8000
Home & Cleaning,Dettol Antiseptic Liquid,3300,0,4,3300,60,FALSE,60,0,1,3600,55,Medium,0.06,3300,198000
Home & Cleaning,Harpic Hygienic Toilet Cleaner Rim Block Citrus,8200,6,6,7700,26,FALSE,26,500,1,676,296.15,High,0.026,7700,200200
Home & Cleaning,Eveready Ultima Alkaline AA Cell Battery-6 Pc Pack,21000,10,6,18900,348,FALSE,6,2100,1,2088,54.31,High,0.348,18900,113400
Home & Cleaning,Mangaldeep Rose Puja Agarbatti ,6500,9,4,5900,120,FALSE,120,600,1,14400,49.17,High,0.12,5900,708000
Home & Cleaning,Ariel Matic Top Load Detergent Washing Powder,22500,0,6,22500,1000,FALSE,1,0,1,1000,22.5,High,1,22500,22500
Home & Cleaning,Gala Cloth Poccha/Mop,12500,9,6,11300,58,FALSE,1,1200,1,58,194.83,High,0.058,11300,11300
Home & Cleaning,Chakaachak Floor Cleaning Pocha,5000,2,6,4900,58,FALSE,1,100,1,58,84.48,High,0.058,4900,4900
Home & Cleaning,Oxi Green Floor Cleaner - Floral,17900,10,6,16100,1000,FALSE,1,1800,0.9,1000,16.1,High,1,16100,16100
Home & Cleaning,"Godrej Aer Pocket, Bathroom Air Fragrance - Assorted Pack Of 3",16000,0,6,16000,30,FALSE,30,0,1,900,533.33,High,0.03,16000,480000
Home & Cleaning,Ariel Complete Detergent Washing Powder 1 kg + 500 g Free,28000,6,6,26300,1500,FALSE,1,1700,0.9,1500,17.53,High,1.5,26300,26300
Home & Cleaning,Chakaachak Sponge Scrubber (Pack of 2),4500,2,6,4400,116,FALSE,2,100,1,232,37.93,High,0.116,4400,8800
Home & Cleaning,Lizol Disinfectant Surface & Floor Cleaner Liquid Floral,10300,5,6,9700,500,FALSE,500,600,1,250000,19.4,High,0.5,9700,4850000
Home & Cleaning,Harpic Germ & Stain Blaster Disinfectant Toilet Cleaner Floral,14800,7,6,13700,750,FALSE,750,1100,0.9,562500,18.27,High,0.75,13700,10275000
Home & Cleaning,Hit Lime Fresh Flying Insect Killer,26900,0,6,26900,385,FALSE,385,0,1,148225,69.87,High,0.385,26900,10356500
Home & Cleaning,Fevistik Super Glue Stick,4000,2,6,3900,15,FALSE,15,100,1,225,260,High,0.015,3900,58500
Home & Cleaning,Godrej Ezee Liquid Detergent,17500,0,6,17500,1000,FALSE,1,0,0.9,1000,17.5,High,1,17500,17500
Home & Cleaning,Odonil Air Fresher Buy 3 Get 1 Free,22500,5,3,21300,300,FALSE,300,1200,1,90000,71,High,0.3,21300,6390000
Home & Cleaning,"""Godrej Aer Power Pocket - Long Lasting Bathroom Fragrance Fresh Blossom""",5500,0,6,5500,10,FALSE,10,0,1,100,550,High,0.01,5500,55000
Home & Cleaning,Genteel Liquid Detegrent,32000,0,6,32000,2000,FALSE,2,0,0.9,4000,16,High,2,32000,64000
Home & Cleaning,Scotch Brite Scrub Pad,7500,9,6,6800,290,FALSE,5,700,1,1450,23.45,High,0.29,6800,34000
Home & Cleaning,Shubh kart - Nirmal Eco Box Chandan Agarbatti - 100g,6500,13,5,5600,100,FALSE,100,900,1,10000,56,High,0.1,5600,560000
Home & Cleaning,Surf Excel Quick Wash,60000,8,1,54900,4000,FALSE,4,5100,0.9,16000,13.73,High,4,54900,219600
Home & Cleaning,Hem Mantra Masala Agarbatti,8500,7,1,7900,50,FALSE,50,600,1,2500,158,High,0.05,7900,395000
Home & Cleaning,Odonil Room Air Freshener Spray Lavender Mist,14900,5,4,14100,240,FALSE,240,800,1,57600,58.75,High,0.24,14100,3384000
Home & Cleaning,Chakaachak Mega Star Toilet Brush,11000,2,4,10700,58,FALSE,1,300,1,58,184.48,High,0.058,10700,10700
Home & Cleaning,Om Bhakti Wick for Diya - Cotton Long Batti ,1900,0,4,1900,50,FALSE,50,0,1,2500,38,Low,0.05,1900,95000
Home & Cleaning,Origami Non-Woven Kitchen Towel,19000,14,4,16200,80,FALSE,80,2800,1,6400,202.5,High,0.08,16200,1296000
Home & Cleaning,Shubh kart - Nirmal 5 in 1 Agarbatti Zipper - 150g,6500,13,6,5600,150,FALSE,150,900,1,22500,37.33,High,0.15,5600,840000
Home & Cleaning,Harpic Lemon Bathroom Cleaner ,9500,9,6,8600,500,FALSE,500,900,0.9,250000,17.2,High,0.5,8600,4300000
Home & Cleaning,Scotch Brite Sponge Wipes,20000,0,2,20000,174,FALSE,3,0,1,522,114.94,High,0.174,20000,60000
Home & Cleaning,Godrej Aer Spray Fresh Lush Green,15000,16,2,12600,240,FALSE,240,2400,1,57600,52.5,High,0.24,12600,3024000
Home & Cleaning,Oxi Green Phenyl Concentrate,20000,10,6,18000,1000,FALSE,1,2000,1,1000,18,High,1,18000,18000
Home & Cleaning,Oxi Green Max Force Green Concentrate,10700,10,3,9600,500,FALSE,500,1100,1,250000,19.2,High,0.5,9600,4800000
Home & Cleaning,Godrej Aer Morning Misty Meadows Home Air Freshener,15000,0,4,14900,240,FALSE,240,100,1,57600,62.08,High,0.24,14900,3576000
Home & Cleaning,Kiwi Dranex Drain Cleaner,13500,9,1,12200,348,FALSE,6,1300,1,2088,35.06,High,0.348,12200,73200
Home & Cleaning,Origami Disposable Spoons,8000,10,3,7200,1160,FALSE,20,800,0.9,23200,6.21,High,1.16,7200,144000
Home & Cleaning,Pril Bar Tub,5500,0,1,5500,500,FALSE,500,0,0.9,250000,11,High,0.5,5500,2750000
Home & Cleaning,Om Bhakti Wick for Diya - Cotton Flower Batti ,1900,0,4,1900,60,FALSE,60,0,1,3600,31.67,Low,0.06,1900,114000
Home & Cleaning,Chakaachak Deluxe Dustpan Grey,6800,2,3,6600,58,FALSE,1,200,1,58,113.79,High,0.058,6600,6600
Home & Cleaning,Lizol Disinfectant Surface & Floor Cleaner Liquid Citrus,20500,8,3,18800,975,FALSE,975,1700,1,950625,19.28,High,0.975,18800,18330000
Home & Cleaning,ScotchBrite Premium Kitchen Towels,15000,18,3,12300,174,FALSE,1,2700,1,174,70.69,High,0.174,12300,12300
Home & Cleaning,Vanish All in One Powder Detergent Booster,21000,10,2,18900,400,FALSE,400,2100,1,160000,47.25,High,0.4,18900,7560000
Home & Cleaning,Good Knight Fabric Personal Mosquito Repellent Roll On,7500,0,3,7500,8,FALSE,8,0,1,64,937.5,High,0.008,7500,60000
Home & Cleaning,Gala Iron Bull Scrub Pad,14000,10,6,12600,174,FALSE,3,1400,1,522,72.41,High,0.174,12600,37800
Home & Cleaning,Tide Plus Extra Power Lemon & Mint Detergent Powder,21500,1,6,21100,2000,FALSE,2,400,0.9,4000,10.55,High,2,21100,42200
Home & Cleaning,Chakaachak Dustpan Grey,7000,2,5,6800,58,FALSE,1,200,1,58,117.24,High,0.058,6800,6800
Home & Cleaning,Mortein PowerGard Rat Kill Cake,6400,6,6,6000,100,FALSE,100,400,1,10000,60,High,0.1,6000,600000
Home & Cleaning,Odomos Mosquito Repellent Cream,2500,0,1,2500,23,FALSE,25,0,1,575,108.7,Medium,0.023,2500,62500
Home & Cleaning,Shubh kart - Nirmal Eco Box Sugandhi Mogra Agarbatti - 100g,6500,13,6,5600,100,FALSE,100,900,1,10000,56,High,0.1,5600,560000
Home & Cleaning,Cherry Blossom Wax Shoe Polish Black,6800,5,6,6400,40,FALSE,40,400,1,1600,160,High,0.04,6400,256000
Home & Cleaning,Origami Paper Plates,24000,15,5,20400,50,FALSE,50,3600,1,2500,408,High,0.05,20400,1020000
Home & Cleaning,Gala Microfiber Magic Cloth 2-In-1,17500,9,6,15800,58,FALSE,1,1700,1,58,272.41,High,0.058,15800,15800
Home & Cleaning,Mr Muscle Dranex Drain Cleaner Kiwi,16000,6,4,14900,375,FALSE,375,1100,1,140625,39.73,High,0.375,14900,5587500
Home & Cleaning,Lizol Disinfectant Surface & Floor Cleaner Liquid Jasmine,10300,5,6,9700,500,FALSE,500,600,1,250000,19.4,High,0.5,9700,4850000
Home & Cleaning,Odonil Room Spray Air Freshener Citrus Fres,15000,12,4,13200,137,FALSE,137,1800,1,18769,96.35,High,0.137,13200,1808400
Home & Cleaning,Scotch Brite Power Scrub Pad,5000,2,6,4900,58,FALSE,1,100,1,58,84.48,High,0.058,4900,4900
Home & Cleaning,Origami Good Karma Toilet Roll,27500,14,6,23400,232,FALSE,1,4100,1,232,100.86,High,0.232,23400,23400
Home & Cleaning,Shubh kart - Shubhkart Sambrani Cup Black 12n,8000,6,4,7500,696,FALSE,12,500,0.9,8352,10.78,High,0.696,7500,90000
Home & Cleaning,Gala Scrubber Pad,7500,9,5,6800,290,FALSE,5,700,1,1450,23.45,High,0.29,6800,34000
Home & Cleaning,Origami So Soft Tissue Roll Single - 340 Pulls 3 Ply,8000,0,1,8000,58,FALSE,1,0,1,58,137.93,High,0.058,8000,8000
Home & Cleaning,Odomos lotion - Mosquito Repellent,9000,8,6,8200,120,FALSE,120,800,1,14400,68.33,High,0.12,8200,984000
Home & Cleaning,Surf Excel Matic Front Load Detergent Powder,53000,4,6,50700,2000,FALSE,2,2300,1,4000,25.35,High,2,50700,101400
Home & Cleaning,Fevicol Mr.Original General Purpose White Glue ,5000,2,6,4900,105,FALSE,100,100,1,10500,46.67,High,0.105,4900,490000
Home & Cleaning,Aro Aluminium Container with Lid 230 ml,7500,9,3,6800,25,FALSE,25,700,1,625,272,High,0.025,6800,170000
Home & Cleaning,Harpic Power Fresh 6 Toilet Cleaner Rim Block Floral Delight,18800,10,6,16900,35,FALSE,35,1900,1,1225,482.86,High,0.035,16900,591500
Home & Cleaning,Origami So Soft Tissue Roll 3 Ply,39000,11,6,34700,696,FALSE,12,4300,1,8352,49.86,High,0.696,34700,416400
Home & Cleaning,Ariel Matic Front Load Detergent Washing Powder,80000,15,6,68000,3000,FALSE,3,12000,1,9000,22.67,High,3,68000,204000
Home & Cleaning,Gala Double Hockey Toilet Brush,15000,10,6,13500,58,FALSE,1,1500,1,58,232.76,High,0.058,13500,13500
Home & Cleaning,Surf Excel Detergent Bar Value Pack,11400,0,6,11400,800,FALSE,800,0,0.9,640000,14.25,High,0.8,11400,9120000
Home & Cleaning,Odonil Zipper Blissful Citrus,5500,0,1,5500,10,FALSE,10,0,1,100,550,High,0.01,5500,55000
Home & Cleaning,Eveready Base B22 9-Watt LED Bulb,15000,0,2,15000,58,FALSE,1,0,1,58,258.62,High,0.058,15000,15000
Home & Cleaning,Scotch Brite Sponge Wipe,33000,10,6,29700,290,FALSE,5,3300,1,1450,102.41,High,0.29,29700,148500
Home & Cleaning,Domex Disinfectant Floor Cleaner,18000,5,6,17000,1000,FALSE,1,1000,0.9,1000,17,High,1,17000,17000
Home & Cleaning,Surf Excel Matic Powder Front Load ,81000,7,2,75000,4000,FALSE,4,6000,1,16000,18.75,High,4,75000,300000
Home & Cleaning,Scotch Brite Silver Sparks Scrub Pad,9000,10,6,8100,348,FALSE,3,900,1,1044,23.28,High,0.348,8100,24300
Home & Cleaning,Airwick Room Air Freshener Spray Cool Water & Aloe Vera,16100,5,6,15200,245,FALSE,245,900,1,60025,62.04,High,0.245,15200,3724000
Home & Cleaning,Shubh kart - Surabhi Camphor Pouch 50g,9500,9,6,8600,50,FALSE,50,900,1,2500,172,High,0.05,8600,430000
Home & Cleaning,Pril Power Of Active Boosters,10200,0,1,10200,400,FALSE,400,0,1,160000,25.5,High,0.4,10200,4080000
Home & Cleaning,Scotch Brite Tough Scrubber Brush,15000,6,6,14000,58,FALSE,1,1000,1,58,241.38,High,0.058,14000,14000
Home & Cleaning,Mortein Dual All Insect Killer Spray,28000,10,6,25200,600,FALSE,600,2800,1,360000,42,High,0.6,25200,15120000
Home & Cleaning,Lizol Double Concentrate Disinfectant Floor Cleaner Lavender,32500,10,6,29200,900,FALSE,900,3300,1,810000,32.44,High,0.9,29200,26280000
Home & Cleaning,Eveready Ultima Alkaline Battery AAA,6800,0,6,6800,116,FALSE,2,0,1,232,58.62,High,0.116,6800,13600
Home & Cleaning,Shubh kart - Tejas Twisted Cotton Wicks 1000n,3000,6,6,2800,1000,FALSE,1000,200,0.7,1000000,2.8,Medium,1,2800,2800000
Home & Cleaning,Lizol Double Concentrate Disinfectant Floor Cleaner Citrus,65000,8,6,59800,1900,FALSE,1,5200,1,1900,31.47,High,1.9,59800,59800
Home & Cleaning,Surf Excel Matic Top Load,72000,9,4,64900,4000,FALSE,4,7100,0.9,16000,16.23,High,4,64900,259600
Home & Cleaning,Oxi Green Dish Wash Liquid - Lemon,10500,6,6,9800,500,FALSE,500,700,1,250000,19.6,High,0.5,9800,4900000
Home & Cleaning,Mangalam Camphor,10000,10,6,9000,50,FALSE,50,1000,1,2500,180,High,0.05,9000,450000
Home & Cleaning,Cherry Blossom Liquid Wax Polish (Dark Tan),9800,5,6,9300,75,FALSE,75,500,1,5625,124,High,0.075,9300,697500
Home & Cleaning,Gala EzeeSqueegee Wiper,15000,10,6,13500,58,FALSE,1,1500,1,58,232.76,High,0.058,13500,13500
Home & Cleaning,Lizol Disinfectant Surface & Floor Cleaner Liquid Pine,20500,8,6,18800,975,FALSE,975,1700,1,950625,19.28,High,0.975,18800,18330000
Home & Cleaning,Philips Stellar Bright 16W Light Bulb,39000,16,6,32400,58,FALSE,1,6600,1,58,558.62,High,0.058,32400,32400
Home & Cleaning,Airwick EverFresh Gel Bathroom Air Freshener - Lavender Dew,7000,10,6,6300,50,FALSE,50,700,1,2500,126,High,0.05,6300,315000
Home & Cleaning,Origami Cups Plain 100 units,15500,14,5,13200,100,FALSE,100,2300,1,10000,132,High,0.1,13200,1320000
Home & Cleaning,Airwick EverFresh Gel Bathroom Air Freshener - Citrus Splash,7000,10,6,6300,50,FALSE,50,700,1,2500,126,High,0.05,6300,315000
Home & Cleaning,Ariel Matic Liquid Detergent Front Load,25000,0,6,25000,1000,FALSE,1,0,1,1000,25,High,1,25000,25000
Home & Cleaning,Om Bhakti Gangajal Packed At Gangotri,3000,3,6,2900,220,FALSE,220,100,0.9,48400,13.18,Medium,0.22,2900,638000
Home & Cleaning,Odonil Air Freshner Lavender Meadows,7500,5,4,7100,75,FALSE,75,400,1,5625,94.67,High,0.075,7100,532500
Home & Cleaning,Om Bhakti Haldi ,1200,0,4,1200,15,FALSE,15,0,1,225,80,Low,0.015,1200,18000
Home & Cleaning,Cherry Blossom Wax Shoe Polish Dark Tan,6800,5,6,6400,40,FALSE,40,400,1,1600,160,High,0.04,6400,256000
Home & Cleaning,Dabur Odomos Naturals Mosquito Repellant Gel,7500,8,4,6900,80,FALSE,80,600,1,6400,86.25,High,0.08,6900,552000
Home & Cleaning,Shubh kart - Nirmal sugandhi mogra wet dhoop zipper 20 sticks,3000,6,6,2800,1160,FALSE,20,200,0.6,23200,2.41,Medium,1.16,2800,56000
Home & Cleaning,Lizol Disinfectant Surface & Floor Cleaner Liquid Floral,20500,8,6,18800,975,FALSE,975,1700,1,950625,19.28,High,0.975,18800,18330000
Home & Cleaning,Om Bhakti Wick for Diya - Ghee Cotton Wicks Big ,18900,10,6,17000,30,FALSE,30,1900,1,900,566.67,High,0.03,17000,510000
Home & Cleaning,Air Wick Room Air Freshener Spray - Lavender & Lotus,16100,5,6,15200,245,FALSE,245,900,1,60025,62.04,High,0.245,15200,3724000
Home & Cleaning,Scotch Brite Kitchen Sink Brush,13500,9,5,12200,58,FALSE,1,1300,1,58,210.34,High,0.058,12200,12200
Home & Cleaning,Odonil Room Air Freshener Spray - Lavender Mist,15000,12,1,13200,137,FALSE,137,1800,1,18769,96.35,High,0.137,13200,1808400
Home & Cleaning,Godrej Aer Power Pocket - Long Lasting Bathroom Fragrance Lavender Bloom,5500,0,4,5500,10,FALSE,10,0,1,100,550,High,0.01,5500,55000
Home & Cleaning,Origami Good Karma Paper Serviettes ,8000,10,6,7200,50,FALSE,50,800,1,2500,144,High,0.05,7200,360000
Home & Cleaning,Scotch Magic Tape,11500,14,6,9800,58,FALSE,1,1700,1,58,168.97,High,0.058,9800,9800
Home & Cleaning,Ambi Pur Car Freshener Gel - Relaxing Lavender,29900,10,2,26900,75,FALSE,75,3000,1,5625,358.67,High,0.075,26900,2017500
Home & Cleaning,Origami Kitchen Towels 4 in 1 60 Pulls 2 Ply,26500,0,6,26500,58,FALSE,1,0,1,58,456.9,High,0.058,26500,26500
Home & Cleaning,Ariel Matic Liquid Detergent Front Load,22500,0,6,22500,1000,FALSE,1,0,1,1000,22.5,High,1,22500,22500
Home & Cleaning,Om Bhakti Wick for Diya - Ghee Cotton Wicks Small ,13900,10,6,12500,30,FALSE,30,1400,1,900,416.67,High,0.03,12500,375000
Home & Cleaning,Chakaachak Super Strong Scrub,2900,3,5,2800,58,FALSE,1,100,1,58,48.28,Medium,0.058,2800,2800
Home & Cleaning,Nimyle Lemongrass Floor Cleaner,16500,5,5,15600,975,FALSE,975,900,0.9,950625,16,High,0.975,15600,15210000
Home & Cleaning,Oxi Green Floor Cleaner - Citrus ,17900,10,6,16100,1000,FALSE,1,1800,0.9,1000,16.1,High,1,16100,16100
Home & Cleaning,Airwick Room Air Freshener Spray - Rose & Saffron,16100,5,5,15200,245,FALSE,245,900,1,60025,62.04,High,0.245,15200,3724000
Home & Cleaning,Origami Luxuria Kitchen Towel 300 Pulls Single,32000,0,2,32000,58,FALSE,1,0,1,58,551.72,High,0.058,32000,32000
Home & Cleaning,Philips EyePro 10.5W Light Bulb,22000,10,6,19800,58,FALSE,1,2200,1,58,341.38,High,0.058,19800,19800
Home & Cleaning,Mangalam Camphor Tablet Jar,28000,10,6,25200,100,FALSE,100,2800,1,10000,252,High,0.1,25200,2520000
Home & Cleaning,Chakaachak Super Sponge Wipes (Pack of 3),14000,0,6,14000,174,FALSE,3,0,1,522,80.46,High,0.174,14000,42000
Home & Cleaning,"""Origami Good Karma Paper Serviettes - 100 napkins (1 ply)""",7800,10,6,7000,58,FALSE,1,800,1,58,120.69,High,0.058,7000,7000
Home & Cleaning,Robin Dazzling Liquid Blue After Wash,7400,5,6,7000,200,FALSE,200,400,1,40000,35,High,0.2,7000,1400000
Home & Cleaning,Om Bhakti Camphor Big,11900,10,6,10700,40,FALSE,40,1200,1,1600,267.5,High,0.04,10700,428000
Home & Cleaning,Om Bhakti Wick for Diya - Cotton Long Batti ,2000,0,6,2000,75,FALSE,75,0,1,5625,26.67,Medium,0.075,2000,150000
Home & Cleaning,Om Bhakti Camphor Small,7900,10,6,7100,25,FALSE,25,800,1,625,284,High,0.025,7100,177500
Home & Cleaning,Ariel Matic Top Load Detergent Washing Powder,49900,0,1,49900,2000,FALSE,2,0,1,4000,24.95,High,2,49900,99800
Home & Cleaning,Scotch Brite Multi-Purpose Sponge Wipes,70000,17,6,58100,580,FALSE,10,11900,1,5800,100.17,High,0.58,58100,581000
Home & Cleaning,Surabhi Pure Camphor,5000,2,6,4900,25,FALSE,25,100,1,625,196,High,0.025,4900,122500
Home & Cleaning,Lizol Double Concentrate Disinfectant Floor Cleaner Citrus,32500,5,6,30800,900,FALSE,900,1700,1,810000,34.22,High,0.9,30800,27720000
Home & Cleaning,Chakaachak Floor Pocha Large,5000,0,1,5000,58,FALSE,1,0,1,58,86.21,High,0.058,5000,5000
Home & Cleaning,Ariel Matic Front Load Liquid Detergent,22000,0,4,22000,1000,FALSE,1,0,1,1000,22,High,1,22000,22000
Home & Cleaning,Harpic Power Fresh 6 Toilet Cleaner Rim Block Marine Splash,18800,10,4,16900,35,FALSE,35,1900,1,1225,482.86,High,0.035,16900,591500
Home & Cleaning,Chakaachak Dust Proof Broom,18000,2,6,17500,58,FALSE,1,500,1,58,301.72,High,0.058,17500,17500
Home & Cleaning,Cherry Blossom Liquid Shoe Polish Neutral ,0,0,1,0,75,FALSE,75,0,#DIV/0!,5625,0,Low,0.075,0,0
Home & Cleaning,Om Bhakti Kumkum ,1200,0,6,1200,15,FALSE,15,0,1,225,80,Low,0.015,1200,18000
Home & Cleaning,Apsara Non Dust Eraser,6000,10,5,5400,1160,FALSE,20,600,0.8,23200,4.66,High,1.16,5400,108000
Home & Cleaning,Chakaachak Power Scrub (Pack of 2),4200,2,6,4100,116,FALSE,2,100,1,232,35.34,High,0.116,4100,8200
Home & Cleaning,Om Bhakti Wick for Diya - Vanaspati Ghee Cotton Wicks Small ,6900,11,6,6100,30,FALSE,30,800,1,900,203.33,High,0.03,6100,183000
Home & Cleaning,Whiskas Adult +1 year Salmon in Gravy,25000,10,3,22500,85,FALSE,1,2500,1,85,264.71,High,0.085,22500,22500
Home & Cleaning,Origami Paper Party Plates,24000,0,6,24000,580,FALSE,50,0,1,29000,41.38,High,0.58,24000,1200000
Home & Cleaning,Gala Microfiber Multipurpose Cloth,14000,7,6,12900,58,FALSE,1,1100,1,58,222.41,High,0.058,12900,12900
Home & Cleaning,Ariel Matic Front Load Detergent Powder,26000,0,6,26000,1000,FALSE,1,0,1,1000,26,High,1,26000,26000
Home & Cleaning,Ariel Matic Liquid Detergent Front Load,25000,0,4,25000,1000,FALSE,1,0,1,1000,25,High,1,25000,25000
Home & Cleaning,Vim Dishwash Bar,2300,4,0,2200,300,TRUE,300,100,0.9,90000,7.33,Medium,0.3,2200,660000
Home & Cleaning,Dettol Effective Protection Antiseptic Liquid,11600,0,0,11600,250,TRUE,250,0,1,62500,46.4,High,0.25,11600,2900000
Home & Cleaning,Godrej Good Night Gold Flash Liquid Vapouriser,8900,0,0,8900,60,TRUE,60,0,1,3600,148.33,High,0.06,8900,534000
Home & Cleaning,Rin Detergent Powder,8600,2,0,8400,1000,TRUE,1,200,0.9,1000,8.4,High,1,8400,8400
Home & Cleaning,Surf Excel Easy Wash Detergent Powder,13600,3,0,13100,1000,TRUE,1,500,0.9,1000,13.1,High,1,13100,13100
Home & Cleaning,Rin Detergent Bar,1000,0,0,1000,140,TRUE,140,0,0.9,19600,7.14,Low,0.14,1000,140000
Home & Cleaning,Odomos Mosquito Repellent Spray,9000,8,0,8200,100,TRUE,100,800,1,10000,82,High,0.1,8200,820000
Home & Cleaning,Chakaachak Super Steel Scrubber,1200,8,0,1100,58,TRUE,1,100,1,58,18.97,Low,0.058,1100,1100
Home & Cleaning,Scotch-Brite Scrub Sponge Ideal For Dishwash Liquid,6500,9,0,5900,116,TRUE,2,600,1,232,50.86,High,0.116,5900,11800
Home & Cleaning,Gala No Dust Broom,19000,7,0,17500,58,TRUE,1,1500,1,58,301.72,High,0.058,17500,17500
Home & Cleaning,Chakaachak Eazo Grass Broom New ,10500,2,0,10200,58,TRUE,1,300,1,58,175.86,High,0.058,10200,10200
Home & Cleaning,Vim Dishwash Bar,4500,0,0,4500,600,TRUE,600,0,0.9,360000,7.5,High,0.6,4500,2700000
Home & Cleaning,Rin Fabric Whitener Detergent,6900,10,0,6200,500,TRUE,500,700,0.9,250000,12.4,High,0.5,6200,3100000
Home & Cleaning,Comfort After Wash Fabric Conditioner Lily Fresh ,23500,9,0,21200,860,TRUE,860,2300,1,739600,24.65,High,0.86,21200,18232000
Home & Cleaning,Ujala Superme For Super Whiteness Of Clothes,2500,0,0,2500,75,TRUE,75,0,1,5625,33.33,Medium,0.075,2500,187500
Home & Cleaning,Surf Excel Quick Wash,20800,6,0,19500,1000,TRUE,1,1300,1,1000,19.5,High,1,19500,19500
Home & Cleaning,Scotch BOPP Packaging Tape,8000,15,0,6800,58,TRUE,1,1200,1,58,117.24,High,0.058,6800,6800
Home & Cleaning,Origami Plates Plain,25000,10,0,22500,100,TRUE,100,2500,1,10000,225,High,0.1,22500,2250000
Home & Cleaning,Dettol Antiseptic Liquid,3000,0,0,3000,60,TRUE,60,0,1,3600,50,Medium,0.06,3000,180000
Health & Hygiene,Epigamia Fruit Yogurt Alphonso Mango,4000,50,6,2000,75,FALSE,75,2000,1,5625,26.67,High,0.075,2000,150000
Health & Hygiene,Epigamia Fruit Yogurt Vanilla,4000,50,6,2000,75,FALSE,75,2000,1,5625,26.67,High,0.075,2000,150000
Health & Hygiene,Nestle A+ Actiplus Probiotic Dahi Plain Curd,7800,3,5,7500,400,FALSE,400,300,0.9,160000,18.75,High,0.4,7500,3000000
Health & Hygiene,Dettol Original Germ Protection Alcohol Based Hand Sanitizer,2500,0,6,2500,50,FALSE,50,0,1,2500,50,Medium,0.05,2500,125000
Health & Hygiene,Dettol Antiseptic Disinfectant Liquid,6600,0,6,6600,125,FALSE,125,0,1,15625,52.8,High,0.125,6600,825000
Health & Hygiene,Durex Air Ultra Thin Condoms,8200,0,6,8200,174,FALSE,3,0,1,522,47.13,High,0.174,8200,24600
Health & Hygiene,Durex Air Ultra Thin Condom,24500,10,6,22000,580,FALSE,10,2500,1,5800,37.93,High,0.58,22000,220000
Health & Hygiene,Dabur Regular Hajmola,4500,6,6,4200,120,FALSE,120,300,1,14400,35,High,0.12,4200,504000
Health & Hygiene,Hajmola Anardana Digestive Tablets,4500,6,2,4200,120,FALSE,180,300,1,21600,35,High,0.12,4200,756000
Health & Hygiene,Zandu Balm,4000,10,4,3600,8,FALSE,8,400,1,64,450,High,0.008,3600,28800
Health & Hygiene,Vicks Cough Drops Menthol,2000,0,6,2000,1160,FALSE,20,0,0.4,23200,1.72,Medium,1.16,2000,40000
Health & Hygiene,Durex Extra Time Condoms,22800,10,6,20500,580,FALSE,10,2300,1,5800,35.34,High,0.58,20500,205000
Health & Hygiene,Vicks Vaporub,8500,9,6,7700,25,FALSE,25,800,1,625,308,High,0.025,7700,192500
Health & Hygiene,Dettol Antiseptic Liquid,3300,0,4,3300,60,FALSE,60,0,1,3600,55,Medium,0.06,3300,198000
Health & Hygiene,Veet Sensitive Skin Hair Removal Cream,13500,5,6,12800,50,FALSE,50,700,1,2500,256,High,0.05,12800,640000
Health & Hygiene,Vicks VapoRub,14500,11,2,12900,50,FALSE,50,1600,1,2500,258,High,0.05,12900,645000
Health & Hygiene,Dabur Hajmola Imli Digestive Tablets,4500,6,6,4200,120,FALSE,120,300,1,14400,35,High,0.12,4200,504000
Health & Hygiene,Dettol Antiseptic Liquid + Disinfectant Spray - Original,15900,10,6,14300,225,FALSE,225,1600,1,50625,63.56,High,0.225,14300,3217500
Health & Hygiene,Iodex Body Pain Expert ,4000,2,6,3900,8,FALSE,8,100,1,64,487.5,High,0.008,3900,31200
Health & Hygiene,Patanjali Hing Goli,6500,10,4,5800,100,FALSE,100,700,1,10000,58,High,0.1,5800,580000
Health & Hygiene,Moov Fast Pain Relief Cream,18900,15,6,16000,50,FALSE,50,2900,1,2500,320,High,0.05,16000,800000
Health & Hygiene,Dettol Hand Sanitizer,10000,5,6,9500,200,FALSE,200,500,1,40000,47.5,High,0.2,9500,1900000
Health & Hygiene,Whisper Ultra Soft XL+ Sanitary Pads,33000,2,6,32300,30,FALSE,30,700,1,900,1076.67,High,0.03,32300,969000
Health & Hygiene,Whisper Choice Regular Wing Sanitary Pad,3000,0,2,3000,406,FALSE,7,0,0.9,2842,7.39,Medium,0.406,3000,21000
Health & Hygiene,Savlon Surface Disinfectant Spray,16500,10,6,14800,170,FALSE,170,1700,1,28900,87.06,High,0.17,14800,2516000
Health & Hygiene,Durex Extra Thin Condoms,22800,10,6,20500,580,FALSE,10,2300,1,5800,35.34,High,0.58,20500,205000
Health & Hygiene,Stayfree Secure Dry Cover Regular Sanitary Pad With Wings,3000,3,6,2900,406,FALSE,7,100,0.9,2842,7.14,Medium,0.406,2900,20300
Health & Hygiene,Eno Fruit Salt Lemon Flavour Energy Powder,13000,10,6,11700,100,FALSE,100,1300,1,10000,117,High,0.1,11700,1170000
Health & Hygiene,Moov Pain Relief Specialist Spray,14900,5,5,14100,35,FALSE,35,800,1,1225,402.86,High,0.035,14100,493500
Health & Hygiene,Savlon Germ Protection Wipes,18900,10,6,17000,72,FALSE,72,1900,1,5184,236.11,High,0.072,17000,1224000
Health & Hygiene,Veet Hair Removal Cream Dry Skin,13500,5,5,12800,50,FALSE,50,700,1,2500,256,High,0.05,12800,640000
Health & Hygiene,Whisper Ultra Soft Air Fresh Sanitary Pads (XL) with Wings,31500,0,4,31500,30,FALSE,30,0,1,900,1050,High,0.03,31500,945000
Health & Hygiene,Whisper Choice Regular Sanitary Pads,9000,0,6,9000,1160,FALSE,20,0,0.9,23200,7.76,High,1.16,9000,180000
Health & Hygiene,Whisper Ultra Clean Wings XL+  Pouch,44900,7,6,41500,44,FALSE,44,3400,1,1936,943.18,High,0.044,41500,1826000
Health & Hygiene,Durex Extra Ribbed Condoms,24500,10,2,22000,580,FALSE,10,2500,1,5800,37.93,High,0.58,22000,220000
Health & Hygiene,Eno Regular Fruit Salt Energy Powder,13000,0,6,13000,100,FALSE,100,0,1,10000,130,High,0.1,13000,1300000
Health & Hygiene,Durex Extra Thin Bubblegum Condom,15000,10,6,13500,580,FALSE,10,1500,1,5800,23.28,High,0.58,13500,135000
Health & Hygiene,Dabur Hajmola Pudina - Digestive Tablets,4500,6,6,4200,120,FALSE,120,300,1,14400,35,High,0.12,4200,504000
Health & Hygiene,Baidyanath Isabgol,11000,22,3,8500,100,FALSE,100,2500,1,10000,85,High,0.1,8500,850000
Health & Hygiene,Kapiva Thar Aloe Vera Juice,29900,15,6,25400,1000,FALSE,1,4500,1,1000,25.4,High,1,25400,25400
Health & Hygiene,Fine Life Cotton Balls,11000,10,6,9900,100,FALSE,100,1100,1,10000,99,High,0.1,9900,990000
Health & Hygiene,Stayfree Dry Max All Night XL Dry Cover Sanitary Pads,34000,12,6,29800,28,FALSE,28,4200,1,784,1064.29,High,0.028,29800,834400
Health & Hygiene,Moov Pain Releiver Spray,29000,15,6,24600,80,FALSE,80,4400,1,6400,307.5,High,0.08,24600,1968000
Health & Hygiene,Whisper Ultra Clean XL Plus Sanitary Pad,17500,0,5,17500,870,FALSE,15,0,1,13050,20.11,High,0.87,17500,262500
Health & Hygiene,Durex Condoms Mutual Climax,12000,0,6,12000,174,FALSE,3,0,1,522,68.97,High,0.174,12000,36000
Health & Hygiene,Durex Extra Dots Condoms,22800,10,6,20500,580,FALSE,10,2300,1,5800,35.34,High,0.58,20500,205000
Health & Hygiene,Zandu Balm Ulter Power For Strong Headache Bodyache & Cold,4500,8,6,4100,8,FALSE,8,400,1,64,512.5,High,0.008,4100,32800
Health & Hygiene,Dabur Hajmola Maha Candy - Aam+Imli,13000,5,1,12300,130,FALSE,130,700,1,16900,94.62,High,0.13,12300,1599000
Health & Hygiene,Whisper Choice Ultra XL Sanitary Pad,13300,2,5,13000,1160,FALSE,20,300,0.9,23200,11.21,High,1.16,13000,260000
Health & Hygiene,Veet Full Body Waxing Kit For Dry Skin,23500,7,6,21800,1160,FALSE,20,1700,1,23200,18.79,High,1.16,21800,436000
Health & Hygiene,Dabur Chyawanprakash - Sugar Free,41500,7,6,38500,900,FALSE,900,3000,1,810000,42.78,High,0.9,38500,34650000
Health & Hygiene,Zandu Balm,8500,10,5,7600,25,FALSE,25,900,1,625,304,High,0.025,7600,190000
Health & Hygiene,Himalaya Cold Balm,12500,9,6,11300,45,FALSE,45,1200,1,2025,251.11,High,0.045,11300,508500
Health & Hygiene,Dettol Clinical Strength Hand Sanitizer Liquid,25000,10,6,22500,500,FALSE,500,2500,1,250000,45,High,0.5,22500,11250000
Health & Hygiene,Kapiva Wild Amla Juice,24900,14,6,21200,1000,FALSE,1,3700,1,1000,21.2,High,1,21200,21200
Health & Hygiene,Dabur Chyawanprash,34900,3,6,33800,950,FALSE,1,1100,1,950,35.58,High,0.95,33800,33800
Health & Hygiene,Amrutanjan Pain Balm Extra Power,10000,11,6,8900,28,FALSE,27,1100,1,756,317.86,High,0.028,8900,240300
Health & Hygiene,Stayfree Dry-Max All Night Ultra-Dry Sanitary Pad,9000,10,6,8100,406,FALSE,7,900,1,2842,19.95,High,0.406,8100,56700
Health & Hygiene,Whisper Ultra Clean XL Plus Sanitary Pad,15500,0,6,15500,870,FALSE,15,0,0.9,13050,17.82,High,0.87,15500,232500
Health & Hygiene,Durex Mutual Climax Condoms,36000,15,6,30600,580,FALSE,10,5400,1,5800,52.76,High,0.58,30600,306000
Health & Hygiene,Whisper Daily Liners Clean and Fresh,10500,0,4,10500,1160,FALSE,20,0,0.9,23200,9.05,High,1.16,10500,210000
Health & Hygiene,Moov Cream Regular,5000,6,4,4700,10,FALSE,10,300,1,100,470,High,0.01,4700,47000
Health & Hygiene,Moov Pain Relief Specialist,7500,5,6,7100,15,FALSE,15,400,1,225,473.33,High,0.015,7100,106500
Health & Hygiene,Dabur Chyawanprakash Sugar Free,23500,5,6,22300,500,FALSE,500,1200,1,250000,44.6,High,0.5,22300,11150000
Health & Hygiene,Baidyanath Isabgol,11000,22,5,8500,100,FALSE,100,2500,1,10000,85,High,0.1,8500,850000
Health & Hygiene,Veet Hair Removal Cream (Normal Skin),13500,5,6,12800,50,FALSE,50,700,1,2500,256,High,0.05,12800,640000
Health & Hygiene,Stayfree Advanced XL Ultra Comfort Sanitary napkins with Wings,17500,0,3,17500,812,FALSE,14,0,1,11368,21.55,High,0.812,17500,245000
Health & Hygiene,Savlon Clothes Disinfectant & Refreshing Spray Fresh Breeze,17500,10,6,15700,230,FALSE,230,1800,1,52900,68.26,High,0.23,15700,3611000
Health & Hygiene,Dabur Chyawanprash Immunity Booster,19000,6,6,17700,500,FALSE,500,1300,1,250000,35.4,High,0.5,17700,8850000
Health & Hygiene,Vicks Inhaler with Keychain,10500,9,4,9500,116,FALSE,2,1000,1,232,81.9,High,0.116,9500,19000
Health & Hygiene,Stayfree Secure XL Size Sanitary Napkins,11500,0,5,11500,1160,FALSE,20,0,0.9,23200,9.91,High,1.16,11500,230000
Health & Hygiene,Dabur Ayurvedic Tulsi Drops (Immunity Booster),19500,6,6,18200,30,FALSE,30,1300,1,900,606.67,High,0.03,18200,546000
Health & Hygiene,Organic India Wheat Grass,39500,20,4,31600,100,FALSE,100,7900,1,10000,316,High,0.1,31600,3160000
Health & Hygiene,Organic India Organic Chyawanprash,49500,20,6,39600,500,FALSE,500,9900,1,250000,79.2,High,0.5,39600,19800000
Health & Hygiene,Organic India Sugar Balance 60 Capsules Bottle,22500,0,6,22500,60,FALSE,60,0,1,3600,375,High,0.06,22500,1350000
Health & Hygiene,Whisper Ultra Soft XL+ Sanitary Pads,55500,0,1,55500,60,FALSE,60,0,1,3600,925,High,0.06,55500,3330000
Health & Hygiene,Dabur - Chyawanprash,9900,0,1,9900,250,FALSE,25,0,1,6250,39.6,High,0.25,9900,247500
Health & Hygiene,Vicks BabyRub,10500,11,6,9300,25,FALSE,25,1200,1,625,372,High,0.025,9300,232500
Health & Hygiene,Bombay Shaving Company Sensitive Cartridges,37500,0,2,37500,116,FALSE,2,0,1,232,323.28,High,0.116,37500,75000
Health & Hygiene,Organic India Brahmi Bottle,20500,20,1,16400,60,FALSE,60,4100,1,3600,273.33,High,0.06,16400,984000
Health & Hygiene,Horlicks Protein Plus Chocolate,27000,0,2,27000,200,FALSE,200,0,1,40000,135,High,0.2,27000,5400000
Health & Hygiene,Dabur Nature Care Isabgol - Double Action,14000,5,6,13300,100,FALSE,100,700,1,10000,133,High,0.1,13300,1330000
Health & Hygiene,Kapiva Wild Tulsi Giloy Juice |,40000,15,1,34000,1000,FALSE,1,6000,1,1000,34,High,1,34000,34000
Health & Hygiene,Dabur Amla Juice,23500,15,6,19900,1000,FALSE,1,3600,1,1000,19.9,High,1,19900,19900
Health & Hygiene,Epigamia Fruit Yogurt Strawberry,4000,50,0,2000,75,TRUE,75,2000,1,5625,26.67,High,0.075,2000,150000
Health & Hygiene,Dettol Effective Protection Antiseptic Liquid,11600,0,0,11600,250,TRUE,250,0,1,62500,46.4,High,0.25,11600,2900000
Health & Hygiene,Stayfree Secure Cottony Soft Cover Sanitary Pad (Regular) with Wings,3000,3,0,2900,406,TRUE,7,100,0.9,2842,7.14,Medium,0.406,2900,20300
Health & Hygiene,"Eno Cooling Sachets - Cool Mint, 6 Pieces Carton",5400,11,0,4800,5,TRUE,5,600,1,25,960,High,0.005,4800,24000
Health & Hygiene,Whisper Choice Sanitary Pad ,3200,9,0,2900,406,TRUE,7,300,0.9,2842,7.14,Medium,0.406,2900,20300
Health & Hygiene,Whisper Bindazzz Nights XL + Sanitary Pad,9000,0,0,9000,406,TRUE,7,0,1,2842,22.17,High,0.406,9000,63000
Health & Hygiene,Gillette Venus Close & Clean Razor ,24900,7,0,23000,58,TRUE,1,1900,1,58,396.55,High,0.058,23000,23000
Health & Hygiene,Whisper Choice Regular Sanitary Pads,9000,3,0,8700,58,TRUE,20,300,1,1160,150,High,0.058,8700,174000
Health & Hygiene,Stayfree Secure Dry Cover Extra Large Sanitary Pad,4200,2,0,4100,406,TRUE,7,100,0.9,2842,10.1,High,0.406,4100,28700
Health & Hygiene,Dabur Honitus Herbal Cough Remedy Ayurvedic Syrup,10500,15,0,8900,100,TRUE,100,1600,1,10000,89,High,0.1,8900,890000
Health & Hygiene,Whisper Bindazzz Night Sanitary Pads XL Plus,18500,0,0,18500,870,TRUE,15,0,1,13050,21.26,High,0.87,18500,277500
Health & Hygiene,Fine Life Cotton Balls,6000,0,0,6000,50,TRUE,50,0,1,2500,120,High,0.05,6000,300000
Health & Hygiene,Dettol Antiseptic Liquid,3000,0,0,3000,60,TRUE,60,0,1,3600,50,Medium,0.06,3000,180000
